time,BME,CDE,FGE,HPE,TVE,Total
1334473200000000000,7,0,0,1,39,47
1334473260000000000,7,0,0,0,39,46
1334473320000000000,7,0,0,0,39,46
1334473380000000000,7,0,1,0,38,46
1334473440000000000,7,0,0,1,38,46
1334473500000000000,7,0,0,1,39,47
1334473560000000000,7,0,0,1,38,46
1334473620000000000,7,0,0,1,38,46
1334473680000000000,7,0,0,44,38,89
1334473740000000000,7,0,0,39,39,85
1334473800000000000,7,0,0,39,38,84
1334473860000000000,7,0,0,38,38,83
1334473920000000000,7,0,0,39,39,85
1334473980000000000,7,0,0,39,38,84
1334474040000000000,7,0,1,38,38,84
1334474100000000000,7,0,0,38,39,84
1334474160000000000,7,0,129,38,39,213
1334474220000000000,7,0,143,38,38,226
1334474280000000000,7,0,131,38,38,214
1334474340000000000,7,0,129,37,39,212
1334474400000000000,7,0,129,38,38,212
1334474460000000000,7,0,127,38,38,210
1334474520000000000,7,0,130,38,38,213
1334474580000000000,7,0,127,38,38,210
1334474640000000000,7,0,126,37,39,209
1334474700000000000,8,0,124,38,39,209
1334474760000000000,7,0,0,37,39,83
1334474820000000000,7,0,0,38,39,84
1334474880000000000,7,0,0,38,39,84
1334474940000000000,7,0,1,39,39,86
1334475000000000000,7,0,0,38,39,84
1334475060000000000,7,0,0,37,38,82
1334475120000000000,7,0,0,39,39,85
1334475180000000000,7,0,0,39,39,85
1334475240000000000,7,0,0,38,39,84
1334475300000000000,7,0,0,38,39,84
1334475360000000000,7,0,0,39,38,84
1334475420000000000,7,0,0,38,39,84
1334475480000000000,7,0,0,37,39,83
1334475540000000000,7,0,0,38,39,84
1334475600000000000,7,0,0,37,38,82
1334475660000000000,7,0,0,37,39,83
1334475720000000000,7,0,0,37,38,82
1334475780000000000,7,0,0,37,39,83
1334475840000000000,7,0,10,37,39,93
1334475900000000000,7,0,7,38,39,91
1334475960000000000,7,0,7,37,39,90
1334476020000000000,7,0,7,38,39,91
1334476080000000000,7,0,7,38,39,91
1334476140000000000,7,0,7,38,38,90
1334476200000000000,7,0,7,39,38,91
1334476260000000000,7,0,153,38,38,236
1334476320000000000,7,0,140,38,38,223
1334476380000000000,7,0,139,37,38,221
1334476440000000000,7,0,137,37,39,220
1334476500000000000,7,0,136,38,38,219
1334476560000000000,7,0,136,38,38,219
1334476620000000000,7,0,133,38,39,217
1334476680000000000,7,0,132,38,38,215
1334476740000000000,7,0,132,38,38,215
1334476800000000000,7,0,132,38,38,215
1334476860000000000,7,0,133,38,38,216
1334476920000000000,7,0,131,38,39,215
1334476980000000000,7,0,131,38,38,214
1334477040000000000,7,0,130,38,38,213
1334477100000000000,7,0,130,38,39,214
1334477160000000000,7,0,130,38,39,214
1334477220000000000,7,0,129,38,38,212
1334477280000000000,7,0,129,37,39,212
1334477340000000000,7,0,129,38,39,213
1334477400000000000,7,0,129,38,38,212
1334477460000000000,7,0,7,37,38,89
1334477520000000000,7,0,7,38,39,91
1334477580000000000,7,0,7,38,38,90
1334477640000000000,7,0,7,38,39,91
1334477700000000000,7,0,10,38,39,94
1334477760000000000,7,0,0,1521,39,1567
1334477820000000000,7,0,0,1666,38,1711
1334477880000000000,7,0,0,1741,39,1787
1334477940000000000,7,0,0,1763,39,1809
1334478000000000000,7,0,0,1778,39,1824
1334478060000000000,7,0,149,1784,38,1978
1334478120000000000,7,0,136,1759,39,1941
1334478180000000000,7,0,130,1766,38,1941
1334478240000000000,7,0,129,1774,39,1949
1334478300000000000,7,0,127,1778,39,1951
1334478360000000000,7,0,126,1785,39,1957
1334478420000000000,7,0,126,1787,39,1959
1334478480000000000,7,0,124,1791,39,1961
1334478540000000000,7,0,124,1793,38,1962
1334478600000000000,7,0,123,1801,39,1970
1334478660000000000,7,0,0,1799,39,1845
1334478720000000000,7,0,0,1806,39,1852
1334478780000000000,7,0,1,1801,39,1848
1334478840000000000,7,0,0,1811,39,1857
1334478900000000000,7,0,1,1,38,47
1334478960000000000,7,0,0,1,39,47
1334479020000000000,7,0,0,1,38,46
1334479080000000000,7,0,0,1,38,46
1334479140000000000,7,0,1,1,39,48
1334479200000000000,7,0,0,1,38,46
1334479260000000000,7,0,0,1,38,46
1334479320000000000,7,0,0,1,38,46
1334479380000000000,7,0,0,1,39,47
1334479440000000000,7,0,0,1,39,47
1334479500000000000,7,0,0,0,39,46
1334479560000000000,7,0,0,1,38,46
1334479620000000000,7,0,0,1,39,47
1334479680000000000,7,0,0,1,40,48
1334479740000000000,7,0,0,1,39,47
1334479800000000000,7,0,1,1,38,47
1334479860000000000,7,0,1,1,39,48
1334479920000000000,7,0,1,1,38,47
1334479980000000000,7,0,1,1,39,48
1334480040000000000,7,0,0,1,39,47
1334480100000000000,7,0,0,41,39,87
1334480160000000000,7,0,0,38,39,84
1334480220000000000,7,0,1,39,38,85
1334480280000000000,7,0,1,38,39,85
1334480340000000000,7,0,0,39,39,85
1334480400000000000,7,0,0,39,39,85
1334480460000000000,7,0,0,38,39,84
1334480520000000000,7,0,0,38,38,83
1334480580000000000,7,0,0,38,39,84
1334480640000000000,7,0,1,39,39,86
1334480700000000000,7,0,0,38,39,84
1334480760000000000,7,0,0,37,39,83
1334480820000000000,7,0,146,38,38,229
1334480880000000000,7,0,135,38,38,218
1334480940000000000,7,0,130,37,38,212
1334481000000000000,7,0,127,37,39,210
1334481060000000000,7,0,127,37,38,209
1334481120000000000,7,0,127,38,38,210
1334481180000000000,7,0,125,38,38,208
1334481240000000000,7,0,124,38,38,207
1334481300000000000,7,0,127,38,39,211
1334481360000000000,7,0,128,37,39,211
1334481420000000000,7,0,0,38,39,84
1334481480000000000,7,0,0,37,39,83
1334481540000000000,7,0,0,38,38,83
1334481600000000000,7,0,0,38,39,84
1334481660000000000,7,0,0,36,39,82
1334481720000000000,7,0,1,37,39,84
1334481780000000000,7,0,1,37,39,84
1334481840000000000,7,0,0,38,39,84
1334481900000000000,7,0,0,38,39,84
1334481960000000000,7,0,0,37,38,82
1334482020000000000,7,0,0,37,38,82
1334482080000000000,7,0,0,38,39,84
1334482140000000000,7,0,0,38,39,84
1334482200000000000,7,0,0,37,39,83
1334482260000000000,7,0,0,37,38,82
1334482320000000000,7,0,0,1238,38,1283
1334482380000000000,7,0,0,1602,39,1648
1334482440000000000,7,0,0,1723,39,1769
1334482500000000000,7,0,1,1759,39,1806
1334482560000000000,7,0,1,1773,38,1819
1334482620000000000,7,0,1,1752,38,1798
1334482680000000000,7,0,0,1760,38,1805
1334482740000000000,7,0,0,1767,39,1813
1334482800000000000,7,0,0,1775,39,1821
1334482860000000000,7,0,0,1784,38,1829
1334482920000000000,7,0,0,1787,39,1833
1334482980000000000,7,0,0,1789,38,1834
1334483040000000000,7,0,0,1795,38,1840
1334483100000000000,7,0,0,1800,39,1846
1334483160000000000,7,0,0,1802,39,1848
1334483220000000000,7,0,0,1805,39,1851
1334483280000000000,7,0,0,1801,39,1847
1334483340000000000,7,0,0,1810,39,1856
1334483400000000000,7,0,0,1807,38,1852
1334483460000000000,7,0,0,1810,39,1856
1334483520000000000,7,0,143,1,38,189
1334483580000000000,7,0,133,1,39,180
1334483640000000000,7,0,129,1,38,175
1334483700000000000,7,0,127,1,38,173
1334483760000000000,7,0,127,1,39,174
1334483820000000000,7,0,126,0,38,171
1334483880000000000,7,0,125,1,38,171
1334483940000000000,7,0,124,0,38,169
1334484000000000000,7,0,123,0,39,169
1334484060000000000,7,0,123,1,39,170
1334484120000000000,7,0,0,1,38,46
1334484180000000000,7,0,0,1,39,47
1334484240000000000,7,0,1,1,38,47
1334484300000000000,7,0,0,1,38,46
1334484360000000000,7,0,1,1,39,48
1334484420000000000,7,0,0,1,39,47
1334484480000000000,7,0,0,0,39,46
1334484540000000000,7,0,0,1,39,47
1334484600000000000,7,0,0,39,38,84
1334484660000000000,7,0,0,39,39,85
1334484720000000000,7,0,0,39,38,84
1334484780000000000,7,0,1,37,38,83
1334484840000000000,7,0,0,38,39,84
1334484900000000000,7,0,0,37,39,83
1334484960000000000,7,0,10,38,39,94
1334485020000000000,7,0,7,37,38,89
1334485080000000000,7,0,0,38,38,83
1334485140000000000,7,0,0,37,39,83
1334485200000000000,7,0,0,38,38,83
1334485260000000000,7,0,0,39,39,85
1334485320000000000,7,0,0,38,38,83
1334485380000000000,7,0,0,37,39,83
1334485440000000000,7,0,0,37,39,83
1334485500000000000,7,0,0,38,38,83
1334485560000000000,7,0,0,38,38,83
1334485620000000000,7,0,0,38,38,83
1334485680000000000,7,0,0,38,39,84
1334485740000000000,7,0,0,37,39,83
1334485800000000000,7,0,0,38,38,83
1334485860000000000,7,0,1,38,39,85
1334485920000000000,7,0,0,38,38,83
1334485980000000000,7,0,143,38,38,226
1334486040000000000,7,0,132,37,38,214
1334486100000000000,7,0,130,38,39,214
1334486160000000000,7,0,128,37,38,210
1334486220000000000,7,0,127,39,38,211
1334486280000000000,7,0,126,37,39,209
1334486340000000000,7,0,124,38,39,208
1334486400000000000,7,0,126,38,38,209
1334486460000000000,7,0,126,37,39,209
1334486520000000000,7,0,127,38,38,210
1334486580000000000,7,0,127,37,38,209
1334486640000000000,7,0,128,37,38,210
1334486700000000000,7,0,127,38,38,210
1334486760000000000,7,0,128,37,39,211
1334486820000000000,7,0,127,38,38,210
1334486880000000000,7,0,0,38,38,83
1334486940000000000,7,0,0,37,39,83
1334487000000000000,7,0,0,37,39,83
1334487060000000000,7,0,0,37,39,83
1334487120000000000,7,0,458,38,38,541
1334487180000000000,7,0,455,37,38,537
1334487240000000000,7,0,452,38,39,536
1334487300000000000,7,0,451,38,38,534
1334487360000000000,7,0,451,37,39,534
1334487420000000000,7,0,451,36,39,533
1334487480000000000,7,0,452,39,38,536
1334487540000000000,7,0,453,38,39,537
1334487600000000000,7,0,455,37,38,537
1334487660000000000,7,0,452,38,39,536
1334487720000000000,7,0,454,37,39,537
1334487780000000000,7,0,454,38,38,537
1334487840000000000,7,0,454,38,39,538
1334487900000000000,7,0,452,38,39,536
1334487960000000000,7,0,454,37,39,537
1334488020000000000,7,0,1,1536,38,1582
1334488080000000000,7,0,1,1677,38,1723
1334488140000000000,7,0,1,1747,39,1794
1334488200000000000,7,0,1,1765,38,1811
1334488260000000000,7,0,156,1787,39,1989
1334488320000000000,7,0,153,1750,38,1948
1334488380000000000,7,0,155,1760,39,1961
1334488440000000000,7,0,157,1766,38,1968
1334488500000000000,7,0,153,1775,38,1973
1334488560000000000,7,0,147,1783,38,1975
1334488620000000000,7,0,145,1785,38,1975
1334488680000000000,7,0,144,1792,39,1982
1334488740000000000,7,0,143,1791,38,1979
1334488800000000000,7,0,143,1799,38,1987
1334488860000000000,7,0,142,1800,39,1988
1334488920000000000,7,0,140,1800,39,1986
1334488980000000000,7,0,140,1802,38,1987
1334489040000000000,7,0,139,1803,39,1988
1334489100000000000,7,0,138,1810,39,1994
1334489160000000000,7,0,138,1809,38,1992
1334489220000000000,7,0,138,1811,39,1995
1334489280000000000,7,0,137,1813,39,1996
1334489340000000000,7,0,137,1816,39,1999
1334489400000000000,7,0,136,0,38,181
1334489460000000000,7,0,136,1,38,182
1334489520000000000,7,0,136,1,39,183
1334489580000000000,7,0,135,1,38,181
1334489640000000000,7,0,135,1,39,182
1334489700000000000,7,0,134,1,39,181
1334489760000000000,7,0,134,1,38,180
1334489820000000000,7,0,134,1,39,181
1334489880000000000,7,0,133,1,39,180
1334489940000000000,7,0,133,0,38,178
1334490000000000000,7,0,133,1,39,180
1334490060000000000,7,0,133,1,38,179
1334490120000000000,7,0,132,1,38,178
1334490180000000000,7,0,131,1,39,178
1334490240000000000,7,0,128,1,39,175
1334490300000000000,7,0,127,1,39,174
1334490360000000000,7,0,126,41,38,212
1334490420000000000,7,0,125,39,38,209
1334490480000000000,7,0,123,38,38,206
1334490540000000000,7,0,0,37,39,83
1334490600000000000,7,0,0,38,39,84
1334490660000000000,7,0,0,37,38,82
1334490720000000000,7,0,0,38,38,83
1334490780000000000,7,0,0,38,39,84
1334490840000000000,7,0,0,37,39,83
1334490900000000000,7,0,1,37,39,84
1334490960000000000,7,0,0,38,38,83
1334491020000000000,7,0,0,37,38,82
1334491080000000000,7,0,0,37,38,82
1334491140000000000,7,0,0,37,38,82
1334491200000000000,7,0,0,38,39,84
1334491260000000000,7,0,0,37,38,82
1334491320000000000,7,0,0,39,38,84
1334491380000000000,7,0,0,37,38,82
1334491440000000000,7,0,0,37,39,83
1334491500000000000,7,0,0,37,39,83
1334491560000000000,7,0,0,37,39,83
1334491620000000000,7,0,0,37,39,83
1334491680000000000,7,0,0,38,38,83
1334491740000000000,7,0,0,38,38,83
1334491800000000000,7,0,0,1056,39,1102
1334491860000000000,7,0,1,1596,38,1642
1334491920000000000,7,0,0,1726,39,1772
1334491980000000000,7,0,0,1765,38,1810
1334492040000000000,7,0,124,1775,39,1945
1334492100000000000,7,0,142,1792,39,1980
1334492160000000000,7,0,130,1766,38,1941
1334492220000000000,7,0,128,1773,38,1946
1334492280000000000,7,0,127,1783,39,1956
1334492340000000000,7,0,127,1790,38,1962
1334492400000000000,7,0,126,1789,39,1961
1334492460000000000,7,0,125,1798,39,1969
1334492520000000000,7,0,124,1797,39,1967
1334492580000000000,7,0,124,1803,39,1973
1334492640000000000,7,0,0,1802,39,1848
1334492700000000000,7,0,0,1806,39,1852
1334492760000000000,7,0,0,1808,38,1853
1334492820000000000,7,0,0,1809,38,1854
1334492880000000000,7,0,0,1814,38,1859
1334492940000000000,7,0,0,1816,38,1861
1334493000000000000,7,0,0,1,39,47
1334493060000000000,7,0,0,1,39,47
1334493120000000000,7,0,0,0,38,45
1334493180000000000,7,0,0,1,39,47
1334493240000000000,7,0,0,1,39,47
1334493300000000000,7,0,0,1,39,47
1334493360000000000,7,0,0,1,38,46
1334493420000000000,7,0,0,1,38,46
1334493480000000000,7,0,0,0,38,45
1334493540000000000,7,0,0,1,39,47
1334493600000000000,7,0,0,1,38,46
1334493660000000000,7,0,0,1,38,46
1334493720000000000,7,0,0,1,39,47
1334493780000000000,7,0,10,1,39,57
1334493840000000000,7,0,0,0,39,46
1334493900000000000,7,0,0,1,38,46
1334493960000000000,7,0,0,39,39,85
1334494020000000000,7,0,0,39,38,84
1334494080000000000,7,0,0,38,38,83
1334494140000000000,7,0,0,37,39,83
1334494200000000000,7,0,149,38,39,233
1334494260000000000,7,0,136,38,39,220
1334494320000000000,7,0,128,38,39,212
1334494380000000000,7,0,127,37,39,210
1334494440000000000,7,0,127,37,39,210
1334494500000000000,7,0,125,38,39,209
1334494560000000000,7,0,124,37,38,206
1334494620000000000,7,0,123,37,39,206
1334494680000000000,7,0,124,37,39,207
1334494740000000000,7,0,123,37,38,205
1334494800000000000,7,0,0,38,38,83
1334494860000000000,7,0,0,37,38,82
1334494920000000000,7,0,0,37,38,82
1334494980000000000,7,0,0,36,38,81
1334495040000000000,7,0,0,37,38,82
1334495100000000000,7,0,0,37,39,83
1334495160000000000,7,0,0,36,38,81
1334495220000000000,7,0,0,38,39,84
1334495280000000000,7,0,0,37,39,83
1334495340000000000,7,0,0,37,39,83
1334495400000000000,7,0,0,36,38,81
1334495460000000000,7,0,0,37,39,83
1334495520000000000,7,0,0,36,38,81
1334495580000000000,7,0,0,37,39,83
1334495640000000000,7,0,0,38,38,83
1334495700000000000,7,0,0,36,39,82
1334495760000000000,7,0,0,38,39,84
1334495820000000000,7,0,0,37,39,83
1334495880000000000,7,0,0,38,39,84
1334495940000000000,7,0,0,37,38,82
1334496000000000000,7,0,0,38,38,83
1334496060000000000,7,0,0,37,39,83
1334496120000000000,7,0,0,37,38,82
1334496180000000000,7,0,0,38,38,83
1334496240000000000,7,0,0,37,38,82
1334496300000000000,7,0,0,36,39,82
1334496360000000000,7,0,0,38,38,83
1334496420000000000,7,0,0,37,39,83
1334496480000000000,7,0,0,36,39,82
1334496540000000000,7,0,1,38,39,85
1334496600000000000,7,0,0,37,38,82
1334496660000000000,7,0,0,37,39,83
1334496720000000000,7,0,1,38,38,84
1334496780000000000,7,0,0,38,38,83
1334496840000000000,7,0,143,37,39,226
1334496900000000000,7,0,130,37,38,212
1334496960000000000,7,0,127,36,39,209
1334497020000000000,7,0,127,36,38,208
1334497080000000000,7,0,126,37,39,209
1334497140000000000,7,0,125,1565,39,1736
1334497200000000000,7,0,124,1697,39,1867
1334497260000000000,7,0,123,1752,38,1920
1334497320000000000,7,0,122,1765,38,1932
1334497380000000000,7,0,0,1785,39,1831
1334497440000000000,7,0,8,1750,39,1804
1334497500000000000,7,0,0,1766,38,1811
1334497560000000000,7,0,0,1774,38,1819
1334497620000000000,7,0,1,1778,38,1824
1334497680000000000,7,0,0,1782,38,1827
1334497740000000000,7,0,0,1785,39,1831
1334497800000000000,7,0,0,1789,38,1834
1334497860000000000,7,0,0,1793,39,1839
1334497920000000000,7,0,0,1795,39,1841
1334497980000000000,7,0,0,1799,38,1844
1334498040000000000,7,0,0,1800,39,1846
1334498100000000000,7,0,1,1805,39,1852
1334498160000000000,7,0,0,1802,38,1847
1334498220000000000,7,0,0,1805,38,1850
1334498280000000000,7,0,0,1809,38,1854
1334498340000000000,7,0,1,1811,38,1857
1334498400000000000,7,0,0,1809,38,1854
1334498460000000000,7,0,0,1814,38,1859
1334498520000000000,7,0,0,1811,38,1856
1334498580000000000,7,0,1,1813,39,1860
1334498640000000000,7,0,0,1814,39,1860
1334498700000000000,7,0,0,1,38,46
1334498760000000000,7,0,0,1,38,46
1334498820000000000,7,0,1,1,39,48
1334498880000000000,7,0,0,0,38,45
1334498940000000000,7,0,142,0,38,187
1334499000000000000,7,0,129,1,39,176
1334499060000000000,7,0,127,1,39,174
1334499120000000000,7,0,126,1,39,173
1334499180000000000,7,0,128,0,38,173
1334499240000000000,7,0,128,1,38,174
1334499300000000000,7,0,129,1,38,175
1334499360000000000,7,0,130,1,38,176
1334499420000000000,7,0,129,1,38,175
1334499480000000000,7,0,128,1,38,174
1334499540000000000,7,0,129,1,38,175
1334499600000000000,7,0,129,39,39,214
1334499660000000000,7,0,7,38,39,91
1334499720000000000,7,0,7,38,38,90
1334499780000000000,7,0,7,37,38,89
1334499840000000000,7,0,7,37,39,90
1334499900000000000,7,0,7,36,38,88
1334499960000000000,7,0,7,37,39,90
1334500020000000000,7,0,7,37,38,89
1334500080000000000,7,0,7,36,38,88
1334500140000000000,7,0,7,37,39,90
1334500200000000000,7,0,149,37,39,232
1334500260000000000,7,0,143,37,39,226
1334500320000000000,7,0,135,37,38,217
1334500380000000000,7,0,135,36,38,216
1334500440000000000,7,0,134,37,38,216
1334500500000000000,7,0,133,36,38,214
1334500560000000000,7,0,133,35,39,214
1334500620000000000,7,0,132,37,39,215
1334500680000000000,7,0,132,36,39,214
1334500740000000000,7,0,131,36,38,212
1334500800000000000,7,0,131,36,38,212
1334500860000000000,7,0,130,36,38,211
1334500920000000000,7,0,130,35,38,210
1334500980000000000,7,0,132,37,38,214
1334501040000000000,7,0,127,36,38,208
1334501100000000000,7,0,124,36,38,205
1334501160000000000,7,0,123,36,39,205
1334501220000000000,7,0,1,36,38,82
1334501280000000000,7,0,0,37,38,82
1334501340000000000,7,0,23,37,38,105
1334501400000000000,7,0,0,37,40,84
1334501460000000000,7,0,0,36,38,81
1334501520000000000,7,0,0,36,38,81
1334501580000000000,7,0,0,37,39,83
1334501640000000000,7,0,0,36,39,82
1334501700000000000,7,0,0,37,39,83
1334501760000000000,7,0,0,36,38,81
1334501820000000000,7,0,0,35,38,80
1334501880000000000,7,0,0,1297,39,1343
1334501940000000000,7,0,0,1607,39,1653
1334502000000000000,7,0,0,1727,38,1772
1334502060000000000,7,0,0,1769,38,1814
1334502120000000000,7,0,1,1781,38,1827
1334502180000000000,7,0,0,1792,39,1838
1334502240000000000,7,0,0,1767,38,1812
1334502300000000000,7,0,0,1773,39,1819
1334502360000000000,7,0,0,1781,39,1827
1334502420000000000,7,0,0,1791,39,1837
1334502480000000000,7,0,0,1793,39,1839
1334502540000000000,7,0,0,1793,38,1838
1334502600000000000,7,0,0,1797,38,1842
1334502660000000000,7,0,0,1801,38,1846
1334502720000000000,7,0,0,1801,39,1847
1334502780000000000,7,0,0,1805,38,1850
1334502840000000000,7,0,0,1814,38,1859
1334502900000000000,7,0,0,1809,39,1855
1334502960000000000,7,0,0,1813,39,1859
1334503020000000000,7,0,144,1814,39,2004
1334503080000000000,7,0,129,1818,39,1993
1334503140000000000,7,0,208,1,39,255
1334503200000000000,7,0,127,1,39,174
1334503260000000000,7,0,126,1,39,173
1334503320000000000,7,0,125,1,39,172
1334503380000000000,7,0,127,1,39,174
1334503440000000000,7,0,129,1,39,176
1334503500000000000,7,0,130,2,38,177
1334503560000000000,7,0,132,1,38,178
1334503620000000000,7,0,131,2,38,178
1334503680000000000,7,0,132,2,39,180
1334503740000000000,7,0,132,2,39,180
1334503800000000000,7,0,89,2,39,137
1334503860000000000,7,0,7,2,38,54
1334503920000000000,7,0,7,2,38,54
1334503980000000000,7,0,7,42,39,95
1334504040000000000,7,0,7,38,38,90
1334504100000000000,7,0,7,38,38,90
1334504160000000000,7,0,7,38,39,91
1334504220000000000,7,0,7,38,38,90
1334504280000000000,7,0,147,38,38,230
1334504340000000000,7,0,139,37,38,221
1334504400000000000,7,0,138,37,39,221
1334504460000000000,6,0,138,38,39,221
1334504520000000000,7,0,135,36,38,216
1334504580000000000,7,0,135,37,39,218
1334504640000000000,7,0,133,37,38,215
1334504700000000000,7,0,133,38,38,216
1334504760000000000,7,0,133,37,38,215
1334504820000000000,7,0,132,37,38,214
1334504880000000000,7,0,132,36,39,214
1334504940000000000,7,0,131,37,38,213
1334505000000000000,7,0,130,37,38,212
1334505060000000000,7,0,130,37,38,212
1334505120000000000,7,0,129,37,39,212
1334505180000000000,7,0,129,38,38,212
1334505240000000000,7,0,129,36,38,210
1334505300000000000,7,0,129,36,38,210
1334505360000000000,7,0,128,37,38,210
1334505420000000000,7,0,128,38,38,211
1334505480000000000,7,0,128,36,38,209
1334505540000000000,7,0,128,37,38,210
1334505600000000000,7,0,8,36,38,89
1334505660000000000,7,0,8,36,38,89
1334505720000000000,7,0,8,37,38,90
1334505780000000000,7,0,7,35,38,87
1334505840000000000,7,0,10,37,38,92
1334505900000000000,7,0,1,36,39,83
1334505960000000000,7,0,0,36,38,81
1334506020000000000,7,0,0,36,39,82
1334506080000000000,7,0,0,37,39,83
1334506140000000000,7,0,148,37,38,230
1334506200000000000,7,0,132,35,38,212
1334506260000000000,7,0,130,37,39,213
1334506320000000000,7,0,128,36,38,209
1334506380000000000,7,0,127,37,38,209
1334506440000000000,7,0,126,37,38,208
1334506500000000000,7,0,123,37,38,205
1334506560000000000,7,0,123,35,38,203
1334506620000000000,7,0,122,37,39,205
1334506680000000000,7,0,122,37,38,204
1334506740000000000,7,0,0,37,38,82
1334506800000000000,7,0,0,36,38,81
1334506860000000000,7,0,0,37,39,83
1334506920000000000,7,0,0,36,39,82
1334506980000000000,7,0,0,37,38,82
1334507040000000000,7,0,0,37,39,83
1334507100000000000,7,0,0,36,38,81
1334507160000000000,7,0,0,38,38,83
1334507220000000000,7,0,0,38,38,83
1334507280000000000,7,0,1,36,39,83
1334507340000000000,7,0,0,37,38,82
1334507400000000000,7,0,1,36,38,82
1334507460000000000,7,0,0,37,38,82
1334507520000000000,7,0,0,37,38,82
1334507580000000000,7,0,0,36,38,81
1334507640000000000,7,0,1,37,38,83
1334507700000000000,7,0,0,37,38,82
1334507760000000000,7,0,0,37,39,83
1334507820000000000,7,0,0,36,39,82
1334507880000000000,7,0,0,37,39,83
1334507940000000000,7,0,0,36,38,81
1334508000000000000,7,0,0,36,38,81
1334508060000000000,7,0,0,35,38,80
1334508120000000000,7,0,0,36,38,81
1334508180000000000,7,0,0,36,39,82
1334508240000000000,7,0,0,36,39,82
1334508300000000000,7,0,0,37,39,83
1334508360000000000,7,0,0,37,39,83
1334508420000000000,7,0,0,37,38,82
1334508480000000000,7,0,0,36,38,81
1334508540000000000,7,0,0,36,39,82
1334508600000000000,7,0,0,36,38,81
1334508660000000000,7,0,0,36,39,82
1334508720000000000,7,0,146,36,39,228
1334508780000000000,7,0,132,37,38,214
1334508840000000000,7,0,128,36,38,209
1334508900000000000,7,0,127,37,38,209
1334508960000000000,7,0,125,37,38,207
1334509020000000000,7,0,125,37,38,207
1334509080000000000,7,0,123,36,39,205
1334509140000000000,7,0,123,36,38,204
1334509200000000000,7,0,122,36,39,204
1334509260000000000,7,0,122,36,39,204
1334509320000000000,7,0,0,36,38,81
1334509380000000000,7,0,0,37,39,83
1334509440000000000,7,0,10,38,38,93
1334509500000000000,7,0,10,37,39,93
1334509560000000000,7,0,0,36,38,81
1334509620000000000,7,0,1,37,38,83
1334509680000000000,7,0,0,37,38,82
1334509740000000000,7,0,1,36,38,82
1334509800000000000,7,0,0,36,39,82
1334509860000000000,7,0,0,36,38,81
1334509920000000000,7,0,0,36,38,81
1334509980000000000,7,0,0,36,39,82
1334510040000000000,7,0,0,36,38,81
1334510100000000000,7,0,0,36,39,82
1334510160000000000,7,0,0,36,38,81
1334510220000000000,7,0,0,37,38,82
1334510280000000000,7,0,1,38,38,84
1334510340000000000,7,0,0,36,38,81
1334510400000000000,7,0,0,37,38,82
1334510460000000000,7,0,0,36,38,81
1334510520000000000,7,0,0,36,38,81
1334510580000000000,7,0,0,36,38,81
1334510640000000000,7,0,1,37,121,166
1334510700000000000,7,0,0,37,245,289
1334510760000000000,7,0,0,36,239,282
1334510820000000000,7,0,1,37,256,301
1334510880000000000,7,0,1,36,247,291
1334510940000000000,7,0,0,37,329,373
1334511000000000000,7,0,130,37,218,392
1334511060000000000,7,0,140,36,228,411
1334511120000000000,7,0,128,1020,305,1460
1334511180000000000,7,0,126,1582,281,1996
1334511240000000000,7,0,127,1707,291,2132
1334511300000000000,7,0,124,1738,273,2142
1334511360000000000,7,0,124,1766,276,2173
1334511420000000000,7,0,122,1784,263,2176
1334511480000000000,7,0,122,1760,290,2179
1334511540000000000,7,0,121,1769,267,2164
1334511600000000000,7,0,0,1785,273,2065
1334511660000000000,7,0,0,1782,261,2050
1334511720000000000,7,0,0,1791,267,2065
1334511780000000000,7,0,0,1803,266,2076
1334511840000000000,7,0,0,1803,258,2068
1334511900000000000,7,0,1,1807,246,2061
1334511960000000000,7,0,0,1808,228,2043
1334512020000000000,7,0,0,1814,246,2067
1334512080000000000,7,0,0,1816,245,2068
1334512140000000000,7,0,0,1,244,252
1334512200000000000,7,0,1,1,223,232
1334512260000000000,7,0,1,1,235,244
1334512320000000000,7,0,0,1,259,267
1334512380000000000,7,0,1,1,265,274
1334512440000000000,7,0,0,1,276,284
1334512500000000000,7,0,1,1,324,333
1334512560000000000,7,0,1,1,260,269
1334512620000000000,7,0,0,0,237,244
1334512680000000000,7,0,1,1,232,241
1334512740000000000,7,0,1,1,194,203
1334512800000000000,7,0,0,1,242,250
1334512860000000000,7,0,1,1,232,241
1334512920000000000,7,0,0,1,206,214
1334512980000000000,7,0,0,0,238,245
1334513040000000000,7,0,0,1,259,267
1334513100000000000,7,0,10,38,249,304
1334513160000000000,7,0,7,38,249,301
1334513220000000000,7,0,1,36,275,319
1334513280000000000,7,0,1,36,283,327
1334513340000000000,7,0,0,37,279,323
1334513400000000000,7,0,149,37,283,476
1334513460000000000,7,0,133,37,291,468
1334513520000000000,7,0,130,36,353,526
1334513580000000000,7,0,128,36,399,570
1334513640000000000,7,0,125,37,388,557
1334513700000000000,7,0,125,36,282,450
1334513760000000000,7,0,123,36,253,419
1334513820000000000,7,0,122,36,257,422
1334513880000000000,7,0,122,36,248,413
1334513940000000000,7,0,121,37,282,447
1334514000000000000,7,0,0,37,292,336
1334514060000000000,7,0,1,37,284,329
1334514120000000000,7,0,0,36,290,333
1334514180000000000,7,0,7,36,249,299
1334514240000000000,7,0,7,38,339,391
1334514300000000000,7,0,7,36,293,343
1334514360000000000,7,0,7,37,272,323
1334514420000000000,7,0,8,38,276,329
1334514480000000000,8,0,7,37,292,344
1334514540000000000,8,0,7,37,283,335
1334514600000000000,8,0,7,36,282,333
1334514660000000000,8,0,8,35,225,276
1334514720000000000,8,0,8,36,210,262
1334514780000000000,8,0,147,36,297,488
1334514840000000000,7,0,137,36,305,485
1334514900000000000,7,0,133,36,310,486
1334514960000000000,7,0,133,36,298,474
1334515020000000000,7,0,134,37,290,468
1334515080000000000,7,0,134,36,269,446
1334515140000000000,7,0,132,35,285,459
1334515200000000000,7,0,131,1494,281,1913
1334515260000000000,7,0,131,1681,277,2096
1334515320000000000,7,5,130,1753,249,2144
1334515380000000000,7,9,129,1771,294,2210
1334515440000000000,7,6,129,1790,272,2204
1334515500000000000,7,9,129,1769,260,2174
1334515560000000000,7,6,128,1777,275,2193
1334515620000000000,7,10,128,1779,264,2188
1334515680000000000,7,10,128,1793,266,2204
1334515740000000000,7,4590,127,1795,325,6844
1334515800000000000,7,4548,128,1806,351,6840
1334515860000000000,7,4561,7,1802,292,6669
1334515920000000000,7,4528,7,1807,351,6700
1334515980000000000,7,4537,7,1807,260,6618
1334516040000000000,7,4512,7,1813,263,6602
1334516100000000000,7,4514,1,1,256,4779
1334516160000000000,7,4543,0,2,253,4805
1334516220000000000,7,4517,1,1,251,4777
1334516280000000000,7,4530,1,1,252,4791
1334516340000000000,7,4535,1,1,427,4971
1334516400000000000,7,4550,1,1,245,4804
1334516460000000000,7,4528,150,1,251,4937
1334516520000000000,7,4511,134,1,264,4917
1334516580000000000,7,4541,129,1,255,4933
1334516640000000000,7,4558,127,1,254,4947
1334516700000000000,7,4542,125,1,287,4962
1334516760000000000,7,4550,124,1,49,4731
1334516820000000000,7,4517,125,1,49,4699
1334516880000000000,7,4524,122,1,48,4702
1334516940000000000,7,4513,121,1,49,4691
1334517000000000000,7,4514,122,1,48,4692
1334517060000000000,7,4535,1,1,49,4593
1334517120000000000,7,4519,1,38,49,4614
1334517180000000000,7,4516,0,37,49,4609
1334517240000000000,7,4528,1,37,48,4621
1334517300000000000,7,4516,0,35,48,4606
1334517360000000000,7,4525,1,36,48,4617
1334517420000000000,7,4502,1,36,48,4594
1334517480000000000,7,4503,0,36,49,4595
1334517540000000000,7,4489,0,36,49,4581
1334517600000000000,7,4505,0,36,49,4597
1334517660000000000,7,4511,1,36,49,4604
1334517720000000000,7,4509,1,36,49,4602
1334517780000000000,7,4502,1,36,49,4595
1334517840000000000,7,4502,0,35,48,4592
1334517900000000000,7,258,0,36,49,350
1334517960000000000,7,250,0,36,49,342
1334518020000000000,7,4505,1,36,48,4597
1334518080000000000,7,4478,1,36,49,4571
1334518140000000000,7,4481,79,36,49,4652
1334518200000000000,7,246,0,36,49,338
1334518260000000000,7,243,1,36,49,336
1334518320000000000,7,242,0,37,49,335
1334518380000000000,7,254,0,36,49,346
1334518440000000000,7,235,0,37,49,328
1334518500000000000,7,249,0,36,49,341
1334518560000000000,7,249,1,37,49,343
1334518620000000000,7,254,0,36,49,346
1334518680000000000,7,252,0,36,49,344
1334518740000000000,7,251,5,37,48,348
1334518800000000000,7,246,0,36,49,338
1334518860000000000,8,269,1,36,48,362
1334518920000000000,7,0,1,37,49,94
1334518980000000000,7,0,79,36,38,160
1334519040000000000,7,0,0,36,39,82
1334519100000000000,7,0,1355,37,38,1437
1334519160000000000,7,0,141,37,38,223
1334519220000000000,7,0,131,36,38,212
1334519280000000000,7,0,128,36,38,209
1334519340000000000,8,0,126,36,38,208
1334519400000000000,7,0,125,36,38,206
1334519460000000000,7,0,124,37,38,206
1334519520000000000,7,0,124,36,38,205
1334519580000000000,7,0,124,36,38,205
1334519640000000000,7,0,123,37,38,205
1334519700000000000,7,0,14,36,39,96
1334519760000000000,7,0,1,36,38,82
1334519820000000000,8,0,1,36,39,84
1334519880000000000,7,0,1,36,38,82
1334519940000000000,8,0,1,36,38,83
1334520000000000000,8,0,1,36,39,84
1334520060000000000,7,0,1,36,39,83
1334520120000000000,8,0,1,35,39,83
1334520180000000000,7,0,0,36,38,81
1334520240000000000,7,0,0,36,39,82
1334520300000000000,7,0,0,36,38,81
1334520360000000000,7,0,0,38,39,84
1334520420000000000,7,0,1,37,38,83
1334520480000000000,7,0,0,37,38,82
1334520540000000000,7,0,1,37,38,83
1334520600000000000,7,0,0,37,38,82
1334520660000000000,7,0,10,37,38,92
1334520720000000000,7,0,7,37,38,89
1334520780000000000,7,0,7,37,38,89
1334520840000000000,7,0,7,36,38,88
1334520900000000000,7,0,7,36,38,88
1334520960000000000,7,0,149,1458,38,1652
1334521020000000000,7,0,138,1654,39,1838
1334521080000000000,7,0,135,1749,38,1929
1334521140000000000,7,0,135,1776,38,1956
1334521200000000000,7,0,133,1794,38,1972
1334521260000000000,7,0,135,1767,38,1947
1334521320000000000,7,0,134,1778,38,1957
1334521380000000000,7,0,133,1794,38,1972
1334521440000000000,7,9,132,1802,38,1988
1334521500000000000,7,7,132,1808,38,1992
1334521560000000000,7,4582,131,1808,38,6566
1334521620000000000,7,4596,131,1811,38,6583
1334521680000000000,7,4566,130,1824,38,6565
1334521740000000000,7,4564,129,1818,38,6556
1334521800000000000,7,4585,130,1,38,4761
1334521860000000000,7,4545,130,1,38,4721
1334521920000000000,7,4562,128,1,39,4737
1334521980000000000,7,4543,128,1,38,4717
1334522040000000000,7,4533,127,1,39,4707
1334522100000000000,7,4559,128,1,39,4734
1334522160000000000,7,4542,7,1,39,4596
1334522220000000000,7,4527,7,1,38,4580
1334522280000000000,7,4546,7,1,38,4599
1334522340000000000,7,4526,7,1,38,4579
1334522400000000000,7,4534,7,1,38,4587
1334522460000000000,7,4586,7,0,39,4639
1334522520000000000,7,4535,7,1,39,4589
1334522580000000000,7,4537,7,1,38,4590
1334522640000000000,7,4596,86,1,38,4728
1334522700000000000,7,4562,155,1,38,4763
1334522760000000000,7,4578,142,1,39,4767
1334522820000000000,7,4551,138,1,39,4736
1334522880000000000,7,4556,137,38,38,4776
1334522940000000000,7,4567,136,36,38,4784
1334523000000000000,7,4548,135,37,38,4765
1334523060000000000,7,4558,134,36,38,4773
1334523120000000000,7,4546,133,37,38,4761
1334523180000000000,7,4564,133,36,38,4778
1334523240000000000,7,4533,132,36,39,4747
1334523300000000000,7,4511,131,36,39,4724
1334523360000000000,7,4549,131,37,38,4762
1334523420000000000,7,4532,131,36,38,4744
1334523480000000000,7,4536,129,35,37,4744
1334523540000000000,7,4521,128,36,38,4730
1334523600000000000,7,261,128,36,38,470
1334523660000000000,7,247,127,36,38,455
1334523720000000000,7,252,128,37,38,462
1334523780000000000,7,251,127,36,38,459
1334523840000000000,7,247,124,36,38,452
1334523900000000000,7,254,123,37,39,460
1334523960000000000,7,254,0,36,38,335
1334524020000000000,7,255,0,36,38,336
1334524080000000000,8,258,0,37,38,341
1334524140000000000,7,263,0,37,38,345
1334524200000000000,7,266,0,36,38,347
1334524260000000000,7,263,0,37,38,345
1334524320000000000,7,237,0,37,38,319
1334524380000000000,7,0,0,36,38,81
1334524440000000000,7,0,0,37,38,82
1334524500000000000,7,0,0,35,39,81
1334524560000000000,7,0,0,36,38,81
1334524620000000000,7,0,0,36,38,81
1334524680000000000,7,0,0,36,38,81
1334524740000000000,7,0,0,38,39,84
1334524800000000000,7,0,1,37,39,84
1334524860000000000,7,0,0,37,39,83
1334524920000000000,7,0,0,37,39,83
1334524980000000000,7,0,0,37,38,82
1334525040000000000,7,0,0,37,38,82
1334525100000000000,7,0,0,36,39,82
1334525160000000000,7,0,0,37,38,82
1334525220000000000,7,0,0,37,39,83
1334525280000000000,7,0,0,36,38,81
1334525340000000000,7,0,0,36,39,82
1334525400000000000,7,0,0,37,39,83
1334525460000000000,7,0,0,37,39,83
1334525520000000000,7,0,0,36,39,82
1334525580000000000,7,0,0,37,39,83
1334525640000000000,7,0,144,36,38,225
1334525700000000000,7,0,130,37,38,212
1334525760000000000,7,0,126,36,39,208
1334525820000000000,7,0,127,37,38,209
1334525880000000000,7,0,125,37,38,207
1334525940000000000,7,0,124,36,38,205
1334526000000000000,7,0,122,36,38,203
1334526060000000000,7,0,122,37,38,204
1334526120000000000,7,0,121,37,38,203
1334526180000000000,7,0,121,36,38,202
1334526240000000000,7,0,0,37,38,82
1334526300000000000,7,0,0,36,38,81
1334526360000000000,7,0,0,37,38,82
1334526420000000000,8,0,0,36,38,82
1334526480000000000,8,0,0,35,38,81
1334526540000000000,7,0,0,37,38,82
1334526600000000000,8,0,0,37,38,83
1334526660000000000,8,0,0,37,38,83
1334526720000000000,7,0,0,37,38,82
1334526780000000000,7,0,0,37,38,82
1334526840000000000,7,0,0,37,38,82
1334526900000000000,7,0,0,37,39,83
1334526960000000000,7,0,0,36,38,81
1334527020000000000,7,0,0,36,39,82
1334527080000000000,8,0,0,37,39,84
1334527140000000000,7,0,0,37,39,83
1334527200000000000,7,0,0,37,38,82
1334527260000000000,7,0,0,36,38,81
1334527320000000000,8,0,0,36,38,82
1334527380000000000,7,0,6,37,38,88
1334527440000000000,8,0,0,37,39,84
1334527500000000000,7,0,0,37,39,83
1334527560000000000,8,0,0,35,38,81
1334527620000000000,8,0,0,37,38,83
1334527680000000000,8,0,0,37,38,83
1334527740000000000,8,0,0,36,38,82
1334527800000000000,7,0,0,36,38,81
1334527860000000000,7,0,0,37,39,83
1334527920000000000,7,0,145,37,38,227
1334527980000000000,7,0,132,37,38,214
1334528040000000000,7,0,128,37,39,211
1334528100000000000,8,0,125,37,39,209
1334528160000000000,7,0,125,36,39,207
1334528220000000000,7,0,124,37,38,206
1334528280000000000,7,0,124,37,39,207
1334528340000000000,7,0,123,36,39,205
1334528400000000000,7,0,122,36,39,204
1334528460000000000,7,0,0,37,39,83
1334528520000000000,7,0,0,36,39,82
1334528580000000000,7,0,0,36,38,81
1334528640000000000,7,0,0,37,39,83
1334528700000000000,7,0,0,37,39,83
1334528760000000000,7,0,0,37,39,83
1334528820000000000,7,0,0,37,38,82
1334528880000000000,7,0,0,36,38,81
1334528940000000000,7,0,0,36,38,81
1334529000000000000,7,0,0,37,39,83
1334529060000000000,7,0,0,36,39,82
1334529120000000000,8,0,0,36,38,82
1334529180000000000,7,0,0,38,39,84
1334529240000000000,8,0,0,37,39,84
1334529300000000000,8,0,0,37,39,84
1334529360000000000,7,0,0,37,38,82
1334529420000000000,8,0,0,37,38,83
1334529480000000000,7,0,0,36,38,81
1334529540000000000,7,0,0,37,39,83
1334529600000000000,7,0,0,36,38,81
1334529660000000000,7,0,0,37,38,82
1334529720000000000,7,0,0,36,38,81
1334529780000000000,7,0,0,37,38,82
1334529840000000000,7,0,0,37,38,82
1334529900000000000,7,0,0,37,38,82
1334529960000000000,7,0,0,36,38,81
1334530020000000000,7,0,0,36,38,81
1334530080000000000,8,0,0,36,38,82
1334530140000000000,8,0,0,36,38,82
1334530200000000000,7,0,0,36,38,81
1334530260000000000,8,0,0,36,38,82
1334530320000000000,7,0,0,38,38,83
1334530380000000000,8,0,0,36,38,82
1334530440000000000,8,0,0,36,38,82
1334530500000000000,8,0,0,36,38,82
1334530560000000000,8,0,143,38,38,227
1334530620000000000,7,0,130,37,38,212
1334530680000000000,8,0,126,36,38,208
1334530740000000000,8,0,125,37,39,209
1334530800000000000,7,0,125,37,39,208
1334530860000000000,7,0,125,37,39,208
1334530920000000000,7,0,124,38,38,207
1334530980000000000,7,0,125,36,38,206
1334531040000000000,7,0,127,37,38,209
1334531100000000000,7,0,127,37,39,210
1334531160000000000,7,0,7,37,38,89
1334531220000000000,7,0,7,37,39,90
1334531280000000000,7,0,7,37,38,89
1334531340000000000,7,0,7,37,39,90
1334531400000000000,7,0,7,36,38,88
1334531460000000000,7,0,7,37,39,90
1334531520000000000,7,0,7,38,39,91
1334531580000000000,7,0,7,36,38,88
1334531640000000000,7,0,7,37,38,89
1334531700000000000,7,0,1165,38,39,1249
1334531760000000000,7,0,145,38,39,229
1334531820000000000,7,0,136,35,38,216
1334531880000000000,7,0,134,37,38,216
1334531940000000000,7,0,135,38,38,218
1334532000000000000,7,0,133,38,38,216
1334532060000000000,7,0,132,37,39,215
1334532120000000000,7,0,132,38,39,216
1334532180000000000,7,0,131,37,39,214
1334532240000000000,7,0,131,37,38,213
1334532300000000000,7,0,130,36,39,212
1334532360000000000,7,0,130,36,38,211
1334532420000000000,7,0,130,37,38,212
1334532480000000000,7,0,130,38,39,214
1334532540000000000,7,0,128,37,38,210
1334532600000000000,7,0,128,37,39,211
1334532660000000000,7,0,127,37,38,209
1334532720000000000,7,0,127,37,38,209
1334532780000000000,7,0,128,36,39,210
1334532840000000000,7,0,7,36,38,88
1334532900000000000,7,0,0,37,39,83
1334532960000000000,7,0,0,37,39,83
1334533020000000000,7,0,1,38,38,84
1334533080000000000,7,0,0,37,39,83
1334533140000000000,7,0,0,37,38,82
1334533200000000000,7,0,0,37,38,82
1334533260000000000,7,0,0,37,39,83
1334533320000000000,7,0,0,37,38,82
1334533380000000000,7,0,0,36,38,81
1334533440000000000,7,0,1,35,38,81
1334533500000000000,7,0,0,37,39,83
1334533560000000000,7,0,0,37,39,83
1334533620000000000,7,0,0,35,38,80
1334533680000000000,7,0,0,35,38,80
1334533740000000000,7,0,0,37,38,82
1334533800000000000,7,0,0,37,38,82
1334533860000000000,7,0,0,36,38,81
1334533920000000000,7,0,149,37,39,232
1334533980000000000,7,0,134,37,39,217
1334534040000000000,7,0,127,36,39,209
1334534100000000000,7,0,127,38,39,211
1334534160000000000,7,0,125,37,38,207
1334534220000000000,7,0,124,38,39,208
1334534280000000000,7,0,124,36,39,206
1334534340000000000,7,0,122,37,39,205
1334534400000000000,7,0,122,37,38,204
1334534460000000000,7,0,122,37,38,204
1334534520000000000,7,0,0,37,39,83
1334534580000000000,7,0,1,35,38,81
1334534640000000000,7,0,0,36,38,81
1334534700000000000,7,0,0,35,39,81
1334534760000000000,7,0,0,35,39,81
1334534820000000000,7,0,1,36,38,82
1334534880000000000,7,0,0,36,38,81
1334534940000000000,7,0,0,37,39,83
1334535000000000000,7,0,0,36,39,82
1334535060000000000,7,0,0,36,38,81
1334535120000000000,7,0,0,36,39,82
1334535180000000000,7,0,1,36,39,83
1334535240000000000,7,0,0,36,39,82
1334535300000000000,7,0,1,37,38,83
1334535360000000000,7,0,0,36,38,81
1334535420000000000,7,0,0,35,39,81
1334535480000000000,7,0,0,36,38,81
1334535540000000000,7,0,0,36,38,81
1334535600000000000,7,0,0,36,39,82
1334535660000000000,7,0,0,36,38,81
1334535720000000000,7,0,0,37,38,82
1334535780000000000,7,0,0,36,38,81
1334535840000000000,7,0,0,36,39,82
1334535900000000000,7,0,1,36,38,82
1334535960000000000,7,0,0,36,39,82
1334536020000000000,7,0,1,36,38,82
1334536080000000000,7,0,0,38,38,83
1334536140000000000,7,0,0,36,38,81
1334536200000000000,7,0,0,37,38,82
1334536260000000000,7,0,1,37,38,83
1334536320000000000,7,0,0,36,39,82
1334536380000000000,8,0,1,36,38,83
1334536440000000000,7,0,10,36,38,91
1334536500000000000,7,0,7,36,38,88
1334536560000000000,7,0,150,36,38,231
1334536620000000000,7,0,135,35,38,215
1334536680000000000,7,0,127,38,39,211
1334536740000000000,7,0,127,36,38,208
1334536800000000000,7,0,125,37,38,207
1334536860000000000,7,0,126,35,38,206
1334536920000000000,7,0,124,35,38,204
1334536980000000000,7,0,123,36,38,204
1334537040000000000,7,0,122,36,38,203
1334537100000000000,7,0,121,35,39,202
1334537160000000000,7,0,0,37,38,82
1334537220000000000,7,0,1,35,38,81
1334537280000000000,7,0,0,36,39,82
1334537340000000000,7,0,1,36,38,82
1334537400000000000,7,0,0,36,38,81
1334537460000000000,7,0,0,36,38,81
1334537520000000000,7,0,0,36,38,81
1334537580000000000,7,0,0,35,38,80
1334537640000000000,7,0,0,36,38,81
1334537700000000000,7,0,0,36,38,81
1334537760000000000,7,0,0,35,39,81
1334537820000000000,7,0,1,36,38,82
1334537880000000000,7,0,0,36,38,81
1334537940000000000,7,0,0,36,39,82
1334538000000000000,7,0,0,36,38,81
1334538060000000000,7,0,0,36,38,81
1334538120000000000,7,0,0,35,38,80
1334538180000000000,7,0,0,36,38,81
1334538240000000000,7,0,0,36,38,81
1334538300000000000,7,0,0,36,39,82
1334538360000000000,7,0,0,36,39,82
1334538420000000000,7,0,0,36,38,81
1334538480000000000,7,0,0,35,39,81
1334538540000000000,7,0,0,35,38,80
1334538600000000000,7,0,0,36,38,81
1334538660000000000,7,0,0,36,38,81
1334538720000000000,7,0,0,35,38,80
1334538780000000000,7,0,0,36,39,82
1334538840000000000,7,0,0,36,38,81
1334538900000000000,7,0,0,35,39,81
1334538960000000000,7,0,0,35,38,80
1334539020000000000,7,0,0,36,38,81
1334539080000000000,7,0,0,37,38,82
1334539140000000000,7,0,0,36,38,81
1334539200000000000,7,0,1,36,39,83
1334539260000000000,7,0,147,36,38,228
1334539320000000000,7,0,137,37,38,219
1334539380000000000,7,0,127,37,38,209
1334539440000000000,7,0,127,36,38,208
1334539500000000000,7,0,126,36,38,207
1334539560000000000,7,0,125,36,38,206
1334539620000000000,7,0,124,36,38,205
1334539680000000000,7,0,123,36,38,204
1334539740000000000,7,0,122,36,39,204
1334539800000000000,7,0,122,36,39,204
1334539860000000000,7,0,0,37,38,82
1334539920000000000,7,0,0,36,38,81
1334539980000000000,7,0,0,36,39,82
1334540040000000000,7,0,0,36,38,81
1334540100000000000,7,0,7,37,39,90
1334540160000000000,7,0,0,36,39,82
1334540220000000000,7,0,0,37,39,83
1334540280000000000,7,0,0,36,39,82
1334540340000000000,7,0,0,37,39,83
1334540400000000000,7,0,0,35,39,81
1334540460000000000,7,0,0,37,39,83
1334540520000000000,7,0,0,35,38,80
1334540580000000000,7,0,0,36,38,81
1334540640000000000,7,0,0,38,39,84
1334540700000000000,7,0,1,36,39,83
1334540760000000000,7,0,0,37,38,82
1334540820000000000,7,0,7,36,38,88
1334540880000000000,7,0,7,36,38,88
1334540940000000000,7,0,7,36,39,89
1334541000000000000,7,0,7,36,38,88
1334541060000000000,7,0,7,36,39,89
1334541120000000000,7,0,155,36,38,236
1334541180000000000,7,0,140,36,38,221
1334541240000000000,7,0,134,35,38,214
1334541300000000000,7,0,134,37,39,217
1334541360000000000,7,0,133,36,38,214
1334541420000000000,7,0,132,36,39,214
1334541480000000000,7,0,132,37,38,214
1334541540000000000,7,0,131,37,39,214
1334541600000000000,7,0,130,37,38,212
1334541660000000000,7,0,130,37,38,212
1334541720000000000,7,0,131,36,38,212
1334541780000000000,7,0,130,37,38,212
1334541840000000000,7,0,129,36,38,210
1334541900000000000,7,0,128,36,38,209
1334541960000000000,7,0,130,37,38,212
1334542020000000000,7,0,128,36,38,209
1334542080000000000,7,0,129,36,39,211
1334542140000000000,7,0,127,35,38,207
1334542200000000000,7,0,7,36,39,89
1334542260000000000,7,0,7,37,38,89
1334542320000000000,7,0,7,37,39,90
1334542380000000000,7,0,7,36,39,89
1334542440000000000,7,0,7,36,38,88
1334542500000000000,7,0,7,38,39,91
1334542560000000000,7,0,7,36,38,88
1334542620000000000,7,0,0,37,38,82
1334542680000000000,7,0,0,37,39,83
1334542740000000000,7,0,0,37,39,83
1334542800000000000,7,0,144,36,38,225
1334542860000000000,7,0,131,36,38,212
1334542920000000000,7,0,128,36,38,209
1334542980000000000,7,0,128,35,38,208
1334543040000000000,7,0,127,37,39,210
1334543100000000000,7,0,125,36,39,207
1334543160000000000,7,0,124,38,38,207
1334543220000000000,7,0,123,36,38,204
1334543280000000000,7,0,122,36,38,203
1334543340000000000,7,0,122,36,38,203
1334543400000000000,7,0,0,36,38,81
1334543460000000000,7,0,0,37,38,82
1334543520000000000,7,0,0,36,38,81
1334543580000000000,7,0,0,36,38,81
1334543640000000000,7,0,0,36,38,81
1334543700000000000,7,0,0,36,38,81
1334543760000000000,7,0,0,36,38,81
1334543820000000000,7,0,0,37,39,83
1334543880000000000,7,0,0,36,39,82
1334543940000000000,7,0,0,36,39,82
1334544000000000000,7,0,0,36,39,82
1334544060000000000,7,0,0,36,38,81
1334544120000000000,7,0,0,35,39,81
1334544180000000000,7,0,0,37,39,83
1334544240000000000,7,0,0,36,38,81
1334544300000000000,7,0,0,35,39,81
1334544360000000000,7,0,0,36,38,81
1334544420000000000,7,0,0,36,39,82
1334544480000000000,7,0,0,35,38,80
1334544540000000000,7,0,0,37,38,82
1334544600000000000,7,0,0,35,38,80
1334544660000000000,7,0,0,36,38,81
1334544720000000000,7,0,0,35,38,80
1334544780000000000,7,0,0,36,38,81
1334544840000000000,7,0,0,36,38,81
1334544900000000000,8,0,0,36,39,83
1334544960000000000,7,0,0,36,38,81
1334545020000000000,7,0,0,36,38,81
1334545080000000000,7,0,0,36,38,81
1334545140000000000,7,0,0,35,38,80
1334545200000000000,8,0,0,35,38,81
1334545260000000000,7,0,0,36,38,81
1334545320000000000,7,0,0,35,38,80
1334545380000000000,7,0,0,36,38,81
1334545440000000000,7,0,143,34,38,222
1334545500000000000,8,0,131,34,39,212
1334545560000000000,7,0,127,35,38,207
1334545620000000000,7,0,125,36,38,206
1334545680000000000,7,0,124,36,38,205
1334545740000000000,7,0,123,35,38,203
1334545800000000000,7,0,122,35,38,202
1334545860000000000,8,0,123,35,39,205
1334545920000000000,7,0,120,35,38,200
1334545980000000000,7,0,123,36,38,204
1334546040000000000,7,0,6,36,38,87
1334546100000000000,7,0,6,35,39,87
1334546160000000000,7,0,6,36,38,87
1334546220000000000,7,0,6,35,38,86
1334546280000000000,7,0,6,35,38,86
1334546340000000000,7,0,6,34,38,85
1334546400000000000,7,0,6,36,38,87
1334546460000000000,7,0,6,36,38,87
1334546520000000000,7,0,6,36,38,87
1334546580000000000,7,0,6,36,39,88
1334546640000000000,7,0,145,1607,38,1797
1334546700000000000,7,0,134,1673,38,1852
1334546760000000000,7,0,135,1746,38,1926
1334546820000000000,7,0,134,1766,39,1946
1334546880000000000,7,0,134,1750,39,1930
1334546940000000000,7,0,132,1759,38,1936
1334547000000000000,7,0,131,1770,38,1946
1334547060000000000,7,0,131,1779,38,1955
1334547120000000000,7,0,132,1791,38,1968
1334547180000000000,7,0,130,1799,39,1975
1334547240000000000,7,0,129,1803,38,1977
1334547300000000000,7,0,129,1806,39,1981
1334547360000000000,7,0,129,1809,38,1983
1334547420000000000,7,0,128,1813,38,1986
1334547480000000000,7,0,128,1818,38,1991
1334547540000000000,7,0,128,1816,38,1989
1334547600000000000,7,0,127,1821,39,1994
1334547660000000000,7,0,127,1822,38,1994
1334547720000000000,7,0,128,1825,39,1999
1334547780000000000,7,0,7,1,39,54
1334547840000000000,7,0,7,1,38,53
1334547900000000000,7,0,7,1,39,54
1334547960000000000,7,0,7,1,39,54
1334548020000000000,7,0,7,0,39,53
1334548080000000000,7,0,9,1,39,56
1334548140000000000,7,0,0,1,38,46
1334548200000000000,7,0,0,1,39,47
1334548260000000000,7,0,0,1,38,46
1334548320000000000,7,0,146,0,38,191
1334548380000000000,7,0,132,0,39,178
1334548440000000000,7,0,129,1,38,175
1334548500000000000,7,0,127,1,39,174
1334548560000000000,7,0,126,1,38,172
1334548620000000000,7,0,125,1,39,172
1334548680000000000,7,0,123,1,38,169
1334548740000000000,7,0,123,1,38,169
1334548800000000000,7,0,122,1,38,168
1334548860000000000,7,0,121,0,39,167
1334548920000000000,7,0,0,1,39,47
1334548980000000000,7,0,0,1,39,47
1334549040000000000,7,0,1,38,39,85
1334549100000000000,7,0,0,38,38,83
1334549160000000000,7,0,0,36,39,82
1334549220000000000,7,0,0,36,39,82
1334549280000000000,7,0,0,36,39,82
1334549340000000000,7,0,0,36,38,81
1334549400000000000,7,0,0,37,38,82
1334549460000000000,7,0,0,38,39,84
1334549520000000000,7,0,0,36,39,82
1334549580000000000,7,0,0,36,39,82
1334549640000000000,7,0,0,37,39,83
1334549700000000000,7,0,0,37,39,83
1334549760000000000,7,0,0,36,39,82
1334549820000000000,7,0,0,36,39,82
1334549880000000000,7,0,0,37,39,83
1334549940000000000,7,0,0,36,39,82
1334550000000000000,7,0,0,37,39,83
1334550060000000000,7,0,0,36,39,82
1334550120000000000,7,0,0,37,39,83
1334550180000000000,7,0,0,37,39,83
1334550240000000000,7,0,0,36,39,82
1334550300000000000,7,0,0,35,39,81
1334550360000000000,7,0,0,37,39,83
1334550420000000000,7,0,0,36,39,82
1334550480000000000,7,0,1,37,39,84
1334550540000000000,7,0,0,38,38,83
1334550600000000000,7,0,0,37,39,83
1334550660000000000,7,0,0,36,39,82
1334550720000000000,7,0,0,36,39,82
1334550780000000000,329,0,0,36,147,512
1334550840000000000,328,0,0,36,249,613
1334550900000000000,327,0,142,36,278,783
1334550960000000000,328,0,129,36,218,711
1334551020000000000,328,0,126,36,235,725
1334551080000000000,328,0,125,35,215,703
1334551140000000000,328,0,124,36,240,728
1334551200000000000,328,0,123,36,226,713
1334551260000000000,328,0,123,36,241,728
1334551320000000000,329,0,122,38,258,747
1334551380000000000,328,0,121,37,259,745
1334551440000000000,328,0,121,37,270,756
1334551500000000000,328,0,0,36,212,576
1334551560000000000,328,0,0,36,234,598
1334551620000000000,328,0,0,35,220,583
1334551680000000000,328,0,10,36,221,595
1334551740000000000,328,0,10,36,304,678
1334551800000000000,329,0,0,37,229,595
1334551860000000000,328,0,0,36,231,595
1334551920000000000,329,0,0,37,233,599
1334551980000000000,329,0,0,37,219,585
1334552040000000000,329,0,0,35,289,653
1334552100000000000,330,0,0,37,366,733
1334552160000000000,329,0,0,36,341,706
1334552220000000000,331,0,0,38,259,628
1334552280000000000,330,0,0,36,232,598
1334552340000000000,331,0,0,36,239,606
1334552400000000000,331,0,0,36,283,650
1334552460000000000,333,0,0,37,242,612
1334552520000000000,333,0,0,37,249,619
1334552580000000000,330,0,0,36,286,652
1334552640000000000,329,0,0,36,300,665
1334552700000000000,332,0,0,37,258,627
1334552760000000000,331,0,0,36,276,643
1334552820000000000,330,0,0,36,244,610
1334552880000000000,331,0,0,36,252,619
1334552940000000000,331,0,0,37,318,686
1334553000000000000,332,0,0,37,265,634
1334553060000000000,332,0,0,36,258,626
1334553120000000000,332,0,0,36,250,618
1334553180000000000,332,0,0,36,246,614
1334553240000000000,332,0,145,36,245,758
1334553300000000000,333,0,132,36,244,745
1334553360000000000,334,0,127,37,260,758
1334553420000000000,333,0,127,36,261,757
1334553480000000000,329,0,125,36,243,733
1334553540000000000,330,0,125,37,242,734
1334553600000000000,329,0,123,36,256,744
1334553660000000000,329,0,124,35,258,746
1334553720000000000,330,0,122,37,259,748
1334553780000000000,331,0,0,35,254,620
1334553840000000000,330,0,0,37,288,655
1334553900000000000,329,0,0,36,381,746
1334553960000000000,329,0,0,36,243,608
1334554020000000000,329,0,0,36,259,624
1334554080000000000,330,0,0,36,265,631
1334554140000000000,329,0,7,37,345,718
1334554200000000000,329,0,6,37,253,625
1334554260000000000,329,0,6,36,222,593
1334554320000000000,331,0,7,37,225,600
1334554380000000000,330,0,6,36,375,747
1334554440000000000,331,0,6,36,395,768
1334554500000000000,332,0,6,37,207,582
1334554560000000000,332,0,6,38,213,589
1334554620000000000,333,0,7,36,218,594
1334554680000000000,332,0,156,36,212,736
1334554740000000000,334,0,140,36,231,741
1334554800000000000,334,0,135,37,247,753
1334554860000000000,335,0,134,36,223,728
1334554920000000000,333,0,134,36,222,725
1334554980000000000,334,0,133,36,229,732
1334555040000000000,334,0,132,37,232,735
1334555100000000000,335,0,132,37,270,774
1334555160000000000,335,0,132,36,242,745
1334555220000000000,335,0,131,37,221,724
1334555280000000000,334,0,130,36,272,772
1334555340000000000,333,0,131,37,253,754
1334555400000000000,333,0,129,37,214,713
1334555460000000000,335,0,130,37,212,714
1334555520000000000,336,0,129,38,228,731
1334555580000000000,335,0,128,37,224,724
1334555640000000000,335,0,130,37,217,719
1334555700000000000,337,0,128,37,222,724
1334555760000000000,336,0,128,36,220,720
1334555820000000000,336,0,7,37,213,593
1334555880000000000,335,0,7,36,209,587
1334555940000000000,337,0,7,36,212,592
1334556000000000000,337,0,7,38,226,608
1334556060000000000,337,0,7,36,221,601
1334556120000000000,337,0,0,38,226,601
1334556180000000000,333,0,0,37,217,587
1334556240000000000,332,0,0,37,217,586
1334556300000000000,332,0,0,36,227,595
1334556360000000000,330,0,0,36,219,585
1334556420000000000,331,0,144,37,220,732
1334556480000000000,330,0,132,37,221,720
1334556540000000000,331,0,128,36,276,771
1334556600000000000,332,0,127,37,212,708
1334556660000000000,332,0,125,37,214,708
1334556720000000000,333,0,124,36,212,705
1334556780000000000,333,0,124,37,222,716
1334556840000000000,334,0,122,37,217,710
1334556900000000000,334,0,122,36,221,713
1334556960000000000,333,0,0,36,223,592
1334557020000000000,333,0,0,36,209,578
1334557080000000000,334,0,0,37,136,507
1334557140000000000,7,0,0,38,37,82
1334557200000000000,7,0,0,37,37,81
1334557260000000000,7,0,0,37,38,82
1334557320000000000,7,0,0,38,37,82
1334557380000000000,7,0,1,36,37,81
1334557440000000000,7,0,0,36,38,81
1334557500000000000,7,0,0,37,37,81
1334557560000000000,7,0,0,38,37,82
1334557620000000000,7,0,0,37,37,81
1334557680000000000,7,0,0,37,37,81
1334557740000000000,7,0,1,37,37,82
1334557800000000000,7,0,0,37,38,82
1334557860000000000,7,0,0,36,38,81
1334557920000000000,7,0,0,37,38,82
1334557980000000000,7,0,0,38,38,83
1334558040000000000,7,0,0,37,38,82
1334558100000000000,7,0,0,37,38,82
1334558160000000000,7,0,0,37,39,83
1334558220000000000,7,0,0,36,38,81
1334558280000000000,7,0,0,37,38,82
1334558340000000000,7,0,0,38,38,83
1334558400000000000,7,0,0,37,38,82
1334558460000000000,7,0,0,38,38,83
1334558520000000000,7,0,0,38,38,83
1334558580000000000,7,0,0,37,38,82
1334558640000000000,7,0,0,38,38,83
1334558700000000000,7,0,0,38,38,83
1334558760000000000,7,0,0,37,38,82
1334558820000000000,7,0,0,38,38,83
1334558880000000000,7,0,0,36,38,81
1334558940000000000,7,0,0,37,38,82
1334559000000000000,7,0,0,37,39,83
1334559060000000000,7,0,145,36,38,226
1334559120000000000,7,0,132,37,37,213
1334559180000000000,7,0,128,37,38,210
1334559240000000000,7,0,127,38,38,210
1334559300000000000,7,0,126,37,38,208
1334559360000000000,7,0,125,38,37,207
1334559420000000000,7,0,125,38,38,208
1334559480000000000,7,0,125,38,38,208
1334559540000000000,7,0,123,38,38,206
1334559600000000000,7,0,122,37,39,205
1334559660000000000,7,0,9,37,38,91
1334559720000000000,7,0,0,38,38,83
1334559780000000000,7,0,0,37,38,82
1334559840000000000,7,0,1,38,38,84
1334559900000000000,7,0,0,38,38,83
1334559960000000000,7,0,0,38,38,83
1334560020000000000,7,0,0,38,38,83
1334560080000000000,7,0,0,37,38,82
1334560140000000000,7,0,1,39,38,85
1334560200000000000,7,0,0,38,38,83
1334560260000000000,7,0,0,38,38,83
1334560320000000000,7,0,0,38,38,83
1334560380000000000,7,0,0,38,38,83
1334560440000000000,7,0,0,38,38,83
1334560500000000000,7,0,0,37,38,82
1334560560000000000,7,0,0,37,38,82
1334560620000000000,7,0,0,38,38,83
1334560680000000000,7,0,0,38,38,83
1334560740000000000,7,0,0,38,38,83
1334560800000000000,7,0,0,38,39,84
1334560860000000000,7,0,0,37,38,82
1334560920000000000,7,0,0,38,38,83
1334560980000000000,7,0,1,38,38,84
1334561040000000000,7,0,0,38,38,83
1334561100000000000,7,0,0,38,38,83
1334561160000000000,7,0,0,38,38,83
1334561220000000000,7,0,0,38,38,83
1334561280000000000,7,0,0,38,38,83
1334561340000000000,7,0,148,1460,38,1653
1334561400000000000,7,0,135,1621,38,1801
1334561460000000000,7,0,129,1709,38,1883
1334561520000000000,7,0,128,1751,38,1924
1334561580000000000,7,0,127,1777,38,1949
1334561640000000000,7,0,126,1751,38,1922
1334561700000000000,7,0,124,1760,38,1929
1334561760000000000,7,0,125,1771,39,1942
1334561820000000000,7,0,123,1779,38,1947
1334561880000000000,7,0,122,1791,38,1958
1334561940000000000,7,0,0,1791,38,1836
1334562000000000000,7,0,0,1795,38,1840
1334562060000000000,7,0,0,1801,38,1846
1334562120000000000,7,0,0,1801,38,1846
1334562180000000000,7,0,1,1802,38,1848
1334562240000000000,7,0,1,1809,37,1854
1334562300000000000,7,0,0,1,38,46
1334562360000000000,7,0,0,1,38,46
1334562420000000000,7,0,0,1,38,46
1334562480000000000,7,0,0,1,38,46
1334562540000000000,7,0,0,1,38,46
1334562600000000000,7,0,0,1,38,46
1334562660000000000,7,0,0,1,38,46
1334562720000000000,7,0,0,1,38,46
1334562780000000000,7,0,0,1,38,46
1334562840000000000,7,0,0,1,38,46
1334562900000000000,7,0,0,1,38,46
1334562960000000000,7,0,0,1,38,46
1334563020000000000,7,0,0,1,38,46
1334563080000000000,7,0,7,1,39,54
1334563140000000000,7,0,7,1,38,53
1334563200000000000,7,0,7,1,38,53
1334563260000000000,7,0,7,1,38,53
1334563320000000000,7,0,7,42,38,94
1334563380000000000,7,0,7,41,38,93
1334563440000000000,7,0,149,39,39,234
1334563500000000000,7,0,139,38,38,222
1334563560000000000,7,0,137,38,37,219
1334563620000000000,7,0,135,38,38,218
1334563680000000000,7,0,134,37,38,216
1334563740000000000,7,0,134,38,38,217
1334563800000000000,7,0,134,37,38,216
1334563860000000000,7,0,132,38,38,215
1334563920000000000,7,0,133,37,38,215
1334563980000000000,7,0,132,38,38,215
1334564040000000000,7,0,132,38,38,215
1334564100000000000,7,0,131,37,38,213
1334564160000000000,7,0,130,38,38,213
1334564220000000000,7,0,130,38,38,213
1334564280000000000,7,0,130,38,38,213
1334564340000000000,7,0,129,38,38,212
1334564400000000000,7,0,129,38,38,212
1334564460000000000,7,0,129,39,38,213
1334564520000000000,7,0,7,38,37,89
1334564580000000000,7,0,7,38,38,90
1334564640000000000,7,0,8,38,38,91
1334564700000000000,7,0,7,39,38,91
1334564760000000000,7,0,7,38,38,90
1334564820000000000,7,0,7,37,38,89
1334564880000000000,7,0,7,39,38,91
1334564940000000000,7,0,10,37,38,92
1334565000000000000,7,0,0,39,38,84
1334565060000000000,7,0,151,38,38,234
1334565120000000000,7,0,140,38,38,223
1334565180000000000,7,0,132,38,38,215
1334565240000000000,7,0,129,38,37,211
1334565300000000000,7,0,128,38,38,211
1334565360000000000,7,0,126,37,38,208
1334565420000000000,7,0,126,38,38,209
1334565480000000000,7,0,125,37,38,207
1334565540000000000,7,0,124,37,39,207
1334565600000000000,7,0,123,38,39,207
1334565660000000000,7,0,124,38,38,207
1334565720000000000,7,0,0,39,38,84
1334565780000000000,7,0,0,38,38,83
1334565840000000000,7,0,0,38,38,83
1334565900000000000,7,0,0,37,38,82
1334565960000000000,7,0,1,37,38,83
1334566020000000000,7,0,0,38,38,83
1334566080000000000,7,0,0,38,38,83
1334566140000000000,7,0,0,38,38,83
1334566200000000000,7,0,0,37,38,82
1334566260000000000,7,0,0,38,38,83
1334566320000000000,7,0,0,39,38,84
1334566380000000000,7,0,0,1344,37,1388
1334566440000000000,7,0,0,1623,38,1668
1334566500000000000,7,0,0,1736,38,1781
1334566560000000000,7,0,1,1767,38,1813
1334566620000000000,7,0,0,1786,38,1831
1334566680000000000,7,0,0,1754,39,1800
1334566740000000000,7,0,0,1777,38,1822
1334566800000000000,7,0,0,1779,38,1824
1334566860000000000,7,0,0,1784,38,1829
1334566920000000000,7,0,0,1792,38,1837
1334566980000000000,7,0,0,1795,38,1840
1334567040000000000,7,0,0,1801,38,1846
1334567100000000000,7,0,1,1803,38,1849
1334567160000000000,7,0,1,1808,38,1854
1334567220000000000,7,0,0,1809,38,1854
1334567280000000000,7,0,0,1814,38,1859
1334567340000000000,7,0,0,1817,38,1862
1334567400000000000,7,0,0,1,38,46
1334567460000000000,7,0,0,1,38,46
1334567520000000000,7,0,0,0,38,45
1334567580000000000,7,0,1,1,38,47
1334567640000000000,7,0,0,1,39,47
1334567700000000000,7,0,0,1,38,46
1334567760000000000,7,0,0,1,38,46
1334567820000000000,7,0,145,1,38,191
1334567880000000000,7,0,131,1,39,178
1334567940000000000,7,0,128,1,38,174
1334568000000000000,7,0,128,0,38,173
1334568060000000000,7,0,126,1,38,172
1334568120000000000,7,0,126,1,38,172
1334568180000000000,7,0,125,1,38,171
1334568240000000000,7,0,124,1,38,170
1334568300000000000,7,0,123,1,38,169
1334568360000000000,7,0,0,1,38,46
1334568420000000000,7,0,0,41,38,86
1334568480000000000,7,0,0,39,38,84
1334568540000000000,7,0,10,38,38,93
1334568600000000000,7,0,7,39,38,91
1334568660000000000,7,0,0,39,38,84
1334568720000000000,7,0,0,38,38,83
1334568780000000000,7,0,0,39,39,85
1334568840000000000,7,0,0,39,38,84
1334568900000000000,7,0,0,38,38,83
1334568960000000000,7,0,0,39,38,84
1334569020000000000,7,0,0,38,38,83
1334569080000000000,7,0,0,38,39,84
1334569140000000000,7,0,0,41,39,87
1334569200000000000,7,0,0,38,38,83
1334569260000000000,7,0,0,39,39,85
1334569320000000000,7,0,1,38,39,85
1334569380000000000,7,0,0,39,38,84
1334569440000000000,7,0,0,37,39,83
1334569500000000000,7,0,0,37,39,83
1334569560000000000,7,0,0,39,38,84
1334569620000000000,7,0,0,39,38,84
1334569680000000000,7,0,0,39,38,84
1334569740000000000,7,0,1,38,38,84
1334569800000000000,7,0,0,38,38,83
1334569860000000000,7,0,0,38,38,83
1334569920000000000,7,0,0,38,38,83
1334569980000000000,7,0,1,38,38,84
1334570040000000000,7,0,0,39,38,84
1334570100000000000,7,0,0,37,38,82
1334570160000000000,7,0,146,39,38,230
1334570220000000000,7,0,132,37,38,214
1334570280000000000,7,0,128,39,38,212
1334570340000000000,7,0,127,38,38,210
1334570400000000000,7,0,127,1400,38,1572
1334570460000000000,7,0,126,1641,38,1812
1334570520000000000,8,0,124,1741,38,1911
1334570580000000000,7,0,125,1775,38,1945
1334570640000000000,7,0,123,1795,38,1963
1334570700000000000,7,0,0,1759,38,1804
1334570760000000000,7,0,0,1775,38,1820
1334570820000000000,7,0,0,1785,38,1830
1334570880000000000,7,0,0,1790,39,1836
1334570940000000000,7,0,1,1795,38,1841
1334571000000000000,7,0,0,1797,38,1842
1334571060000000000,7,0,0,1806,38,1851
1334571120000000000,7,0,0,1808,38,1853
1334571180000000000,7,0,0,1809,38,1854
1334571240000000000,7,0,0,1815,38,1860
1334571300000000000,7,0,0,1817,38,1862
1334571360000000000,7,0,0,1818,38,1863
1334571420000000000,7,0,1,1,38,47
1334571480000000000,7,0,0,1,38,46
1334571540000000000,7,0,0,1,38,46
1334571600000000000,7,0,0,1,39,47
1334571660000000000,7,0,0,1,38,46
1334571720000000000,7,0,0,1,38,46
1334571780000000000,7,0,0,1,38,46
1334571840000000000,7,0,0,1,38,46
1334571900000000000,7,0,0,1,38,46
1334571960000000000,7,0,0,1,37,45
1334572020000000000,7,0,0,1,38,46
1334572080000000000,7,0,0,0,38,45
1334572140000000000,7,0,0,1,39,47
1334572200000000000,7,0,10,1,38,56
1334572260000000000,7,0,7,1,38,53
1334572320000000000,7,0,0,1,38,46
1334572380000000000,7,0,0,1,38,46
1334572440000000000,7,0,0,1,38,46
1334572500000000000,7,0,0,1,38,46
1334572560000000000,7,0,150,41,38,236
1334572620000000000,7,0,141,39,38,225
1334572680000000000,7,0,130,39,38,214
1334572740000000000,7,0,128,38,38,211
1334572800000000000,7,0,127,38,38,210
1334572860000000000,7,0,127,38,38,210
1334572920000000000,7,0,125,39,38,209
1334572980000000000,7,0,127,38,38,210
1334573040000000000,7,0,128,39,38,212
1334573100000000000,7,0,128,41,38,214
1334573160000000000,7,0,8,39,38,92
1334573220000000000,7,0,7,38,38,90
1334573280000000000,7,0,7,39,38,91
1334573340000000000,7,0,7,38,38,90
1334573400000000000,7,0,7,38,38,90
1334573460000000000,7,0,7,39,38,91
1334573520000000000,7,0,7,38,38,90
1334573580000000000,7,0,7,38,38,90
1334573640000000000,7,0,7,39,38,91
1334573700000000000,7,0,7,38,38,90
1334573760000000000,7,0,151,38,38,234
1334573820000000000,7,0,138,38,38,221
1334573880000000000,7,0,136,38,38,219
1334573940000000000,7,0,135,38,38,218
1334574000000000000,7,0,135,38,38,218
1334574060000000000,7,0,134,38,38,217
1334574120000000000,7,0,134,38,37,216
1334574180000000000,7,0,133,39,39,218
1334574240000000000,7,0,132,39,37,215
1334574300000000000,7,0,132,37,38,214
1334574360000000000,7,0,131,1288,38,1464
1334574420000000000,7,0,132,1622,38,1799
1334574480000000000,7,0,131,1737,38,1913
1334574540000000000,7,0,130,1768,38,1943
1334574600000000000,7,0,129,1779,38,1953
1334574660000000000,7,0,130,1797,37,1971
1334574720000000000,7,0,129,1768,38,1942
1334574780000000000,7,0,128,1779,38,1952
1334574840000000000,7,0,7,1783,38,1835
1334574900000000000,7,0,0,1790,38,1835
1334574960000000000,7,0,0,1798,38,1843
1334575020000000000,7,0,0,1799,38,1844
1334575080000000000,7,0,0,1803,38,1848
1334575140000000000,7,0,0,1806,38,1851
1334575200000000000,7,0,0,1809,38,1854
1334575260000000000,7,0,0,1815,38,1860
1334575320000000000,7,0,0,1817,38,1862
1334575380000000000,7,0,0,1,39,47
1334575440000000000,7,0,1,1,38,47
1334575500000000000,7,0,1,1,39,48
1334575560000000000,7,0,0,0,38,45
1334575620000000000,7,0,0,1,38,46
1334575680000000000,7,0,0,1,38,46
1334575740000000000,7,0,0,1,38,46
1334575800000000000,7,0,0,1,38,46
1334575860000000000,7,0,0,1,37,45
1334575920000000000,7,0,0,1,38,46
1334575980000000000,7,0,0,1,38,46
1334576040000000000,7,0,0,1,38,46
1334576100000000000,7,0,0,1,38,46
1334576160000000000,7,0,0,1,38,46
1334576220000000000,7,0,145,1,37,190
1334576280000000000,7,0,133,1,38,179
1334576340000000000,7,0,129,1,38,175
1334576400000000000,7,0,127,41,38,213
1334576460000000000,7,0,127,39,38,211
1334576520000000000,7,0,126,38,38,209
1334576580000000000,7,0,124,38,38,207
1334576640000000000,7,0,123,38,38,206
1334576700000000000,7,0,122,38,38,205
1334576760000000000,7,0,0,38,37,82
1334576820000000000,7,0,0,38,38,83
1334576880000000000,7,0,1,39,38,85
1334576940000000000,7,0,1,38,37,83
1334577000000000000,7,0,1,38,38,84
1334577060000000000,7,0,0,38,38,83
1334577120000000000,7,0,0,38,38,83
1334577180000000000,7,0,0,38,38,83
1334577240000000000,7,0,1,39,38,85
1334577300000000000,7,0,0,39,39,85
1334577360000000000,7,0,0,37,38,82
1334577420000000000,7,0,0,37,38,82
1334577480000000000,7,0,0,39,38,84
1334577540000000000,7,0,0,38,38,83
1334577600000000000,7,0,0,39,39,85
1334577660000000000,7,0,0,37,38,82
1334577720000000000,7,0,0,36,38,81
1334577780000000000,7,0,0,1280,38,1325
1334577840000000000,7,0,0,1607,39,1653
1334577900000000000,7,0,0,1723,38,1768
1334577960000000000,7,0,0,1769,38,1814
1334578020000000000,7,0,0,1786,38,1831
1334578080000000000,7,0,0,1769,38,1814
1334578140000000000,7,0,0,1781,38,1826
1334578200000000000,7,0,0,1791,38,1836
1334578260000000000,7,0,0,1799,38,1844
1334578320000000000,7,0,0,1801,38,1846
1334578380000000000,7,0,0,1809,38,1854
1334578440000000000,7,0,7,1813,38,1865
1334578500000000000,7,0,0,1819,38,1864
1334578560000000000,7,0,0,1823,38,1868
1334578620000000000,7,0,0,1824,38,1869
1334578680000000000,7,0,128,1824,37,1996
1334578740000000000,7,0,142,1826,38,2013
1334578800000000000,7,0,129,1833,38,2007
1334578860000000000,7,0,128,1834,37,2006
1334578920000000000,7,0,127,1832,38,2004
1334578980000000000,7,0,126,1,38,172
1334579040000000000,7,0,125,1,38,171
1334579100000000000,7,0,124,1,38,170
1334579160000000000,7,0,123,1,38,169
1334579220000000000,7,0,122,1,38,168
1334579280000000000,7,0,0,1,38,46
1334579340000000000,7,0,0,1,38,46
1334579400000000000,7,0,0,1,38,46
1334579460000000000,7,0,0,1,38,46
1334579520000000000,7,0,0,1,38,46
1334579580000000000,7,0,0,1,39,47
1334579640000000000,7,0,0,1,38,46
1334579700000000000,7,0,0,1,38,46
1334579760000000000,7,0,0,1,38,46
1334579820000000000,7,0,0,1,38,46
1334579880000000000,7,0,0,1,38,46
1334579940000000000,7,0,0,1,39,47
1334580000000000000,7,0,0,1,38,46
1334580060000000000,7,0,1,39,38,85
1334580120000000000,7,0,0,39,38,84
1334580180000000000,7,0,0,39,38,84
1334580240000000000,7,0,0,38,38,83
1334580300000000000,7,0,0,38,38,83
1334580360000000000,7,0,0,37,38,82
1334580420000000000,7,0,0,38,38,83
1334580480000000000,7,0,0,38,38,83
1334580540000000000,7,0,0,37,38,82
1334580600000000000,7,0,0,37,38,82
1334580660000000000,7,0,0,37,38,82
1334580720000000000,7,0,0,37,38,82
1334580780000000000,7,0,0,37,38,82
1334580840000000000,7,0,0,38,38,83
1334580900000000000,7,0,0,37,38,82
1334580960000000000,7,0,1,38,37,83
1334581020000000000,7,0,0,37,38,82
1334581080000000000,7,0,0,37,38,82
1334581140000000000,7,0,0,37,38,82
1334581200000000000,7,0,0,38,38,83
1334581260000000000,7,0,1,37,38,83
1334581320000000000,7,0,0,37,38,82
1334581380000000000,8,0,127,37,38,210
1334581440000000000,7,0,141,36,38,222
1334581500000000000,7,0,128,38,38,211
1334581560000000000,7,0,127,37,39,210
1334581620000000000,7,0,127,37,38,209
1334581680000000000,7,0,125,38,38,208
1334581740000000000,7,0,124,37,38,206
1334581800000000000,7,0,123,37,38,205
1334581860000000000,7,0,122,37,38,204
1334581920000000000,7,0,122,37,38,204
1334581980000000000,7,0,0,37,38,82
1334582040000000000,7,0,1,1257,37,1302
1334582100000000000,7,0,10,1610,38,1665
1334582160000000000,7,0,0,1707,37,1751
1334582220000000000,7,0,0,1773,38,1818
1334582280000000000,7,0,0,1792,38,1837
1334582340000000000,7,0,0,1774,38,1819
1334582400000000000,7,0,0,1785,37,1829
1334582460000000000,7,0,0,1794,39,1840
1334582520000000000,7,0,0,1802,38,1847
1334582580000000000,7,0,0,1803,38,1848
1334582640000000000,7,0,0,1815,38,1860
1334582700000000000,7,0,0,1818,37,1862
1334582760000000000,7,0,1,1819,38,1865
1334582820000000000,7,0,0,1824,37,1868
1334582880000000000,7,0,1,1824,37,1869
1334582940000000000,7,0,0,1827,38,1872
1334583000000000000,7,0,0,1829,38,1874
1334583060000000000,7,0,0,1831,38,1876
1334583120000000000,7,0,0,1831,38,1876
1334583180000000000,7,0,1,1835,38,1881
1334583240000000000,7,0,0,1837,37,1881
1334583300000000000,7,0,0,1837,38,1882
1334583360000000000,7,0,0,1834,37,1878
1334583420000000000,7,0,0,1,38,46
1334583480000000000,7,0,0,0,39,46
1334583540000000000,7,0,7,0,38,52
1334583600000000000,7,0,7,1,38,53
1334583660000000000,7,0,150,0,38,195
1334583720000000000,7,0,139,1,38,185
1334583780000000000,7,0,135,1,38,181
1334583840000000000,7,0,134,1,38,180
1334583900000000000,7,0,132,1,38,178
1334583960000000000,7,0,132,1,38,178
1334584020000000000,7,0,133,1,38,179
1334584080000000000,7,0,132,1,38,178
1334584140000000000,7,0,132,1,37,177
1334584200000000000,7,0,131,1,38,177
1334584260000000000,7,0,131,1,38,177
1334584320000000000,7,0,130,1,38,176
1334584380000000000,7,0,131,0,37,175
1334584440000000000,7,0,130,39,38,214
1334584500000000000,7,0,128,38,38,211
1334584560000000000,7,0,129,37,38,211
1334584620000000000,7,0,128,37,38,210
1334584680000000000,7,0,128,38,38,211
1334584740000000000,7,0,7,37,38,89
1334584800000000000,7,0,7,37,38,89
1334584860000000000,7,0,7,36,38,88
1334584920000000000,7,0,7,38,38,90
1334584980000000000,7,0,7,36,38,88
1334585040000000000,7,0,7,37,38,89
1334585100000000000,7,0,7,38,38,90
1334585160000000000,7,0,7,37,37,88
1334585220000000000,7,0,7,37,37,88
1334585280000000000,7,0,7,38,38,90
1334585340000000000,7,0,151,37,38,233
1334585400000000000,7,0,136,36,38,217
1334585460000000000,7,0,132,38,37,214
1334585520000000000,7,0,130,37,38,212
1334585580000000000,7,0,128,37,38,210
1334585640000000000,7,0,127,37,37,208
1334585700000000000,7,0,126,38,38,209
1334585760000000000,7,0,125,36,37,205
1334585820000000000,7,0,123,36,37,203
1334585880000000000,7,0,122,36,38,203
1334585940000000000,7,0,121,38,38,204
1334586000000000000,7,0,0,37,38,82
1334586060000000000,7,0,0,36,38,81
1334586120000000000,7,0,0,36,38,81
1334586180000000000,7,0,0,36,38,81
1334586240000000000,7,0,1,36,38,82
1334586300000000000,7,0,0,36,38,81
1334586360000000000,7,0,0,36,38,81
1334586420000000000,7,0,0,37,38,82
1334586480000000000,7,0,0,36,38,81
1334586540000000000,7,0,0,36,38,81
1334586600000000000,7,0,0,36,39,82
1334586660000000000,7,0,0,37,37,81
1334586720000000000,7,0,0,37,38,82
1334586780000000000,7,0,1,37,38,83
1334586840000000000,7,0,0,36,38,81
1334586900000000000,7,0,0,37,37,81
1334586960000000000,7,0,0,35,37,79
1334587020000000000,7,0,0,38,38,83
1334587080000000000,7,0,0,38,38,83
1334587140000000000,7,0,1,36,38,82
1334587200000000000,7,0,0,1518,38,1563
1334587260000000000,7,0,0,1670,38,1715
1334587320000000000,7,0,0,1743,38,1788
1334587380000000000,7,0,0,1773,37,1817
1334587440000000000,7,0,0,1791,38,1836
1334587500000000000,7,0,0,1763,38,1808
1334587560000000000,7,0,0,1776,38,1821
1334587620000000000,7,0,0,1786,38,1831
1334587680000000000,7,0,0,1791,39,1837
1334587740000000000,7,0,0,1798,37,1842
1334587800000000000,7,0,0,1801,38,1846
1334587860000000000,7,0,0,1808,37,1852
1334587920000000000,7,0,1,1807,38,1853
1334587980000000000,7,0,0,1816,38,1861
1334588040000000000,7,0,0,1818,39,1864
1334588100000000000,7,0,144,1821,37,2009
1334588160000000000,7,0,130,1824,37,1998
1334588220000000000,7,0,127,1822,38,1994
1334588280000000000,7,0,126,1827,38,1998
1334588340000000000,7,0,125,1827,38,1997
1334588400000000000,7,0,124,0,38,169
1334588460000000000,7,0,124,1,37,169
1334588520000000000,7,0,123,0,38,168
1334588580000000000,7,0,122,1,38,168
1334588640000000000,7,0,122,1,38,168
1334588700000000000,7,0,0,0,37,44
1334588760000000000,7,0,0,1,37,45
1334588820000000000,7,0,0,1,38,46
1334588880000000000,7,0,0,1,37,45
1334588940000000000,7,0,0,1,38,46
1334589000000000000,7,0,7,1,37,52
1334589060000000000,7,0,0,1,38,46
1334589120000000000,7,0,0,0,37,44
1334589180000000000,7,0,0,1,38,46
1334589240000000000,7,0,1,1,37,46
1334589300000000000,7,0,1,1,37,46
1334589360000000000,7,0,1,0,37,45
1334589420000000000,7,0,79,0,38,124
1334589480000000000,7,0,1,36,38,82
1334589540000000000,7,0,1,37,37,82
1334589600000000000,7,0,1,36,37,81
1334589660000000000,7,0,1,36,38,82
1334589720000000000,7,0,0,36,38,81
1334589780000000000,7,0,0,36,37,80
1334589840000000000,7,0,0,37,38,82
1334589900000000000,7,0,0,35,38,80
1334589960000000000,7,0,0,36,37,80
1334590020000000000,7,0,0,36,38,81
1334590080000000000,7,0,1,37,38,83
1334590140000000000,7,0,0,36,38,81
1334590200000000000,7,0,0,36,39,82
1334590260000000000,7,0,0,36,38,81
1334590320000000000,7,0,0,36,38,81
1334590380000000000,7,0,0,37,38,82
1334590440000000000,7,0,0,36,38,81
1334590500000000000,7,0,0,36,38,81
1334590560000000000,7,0,141,36,38,222
1334590620000000000,7,0,130,36,38,211
1334590680000000000,7,0,127,36,37,207
1334590740000000000,7,0,125,36,38,206
1334590800000000000,7,0,124,36,38,205
1334590860000000000,7,0,125,36,37,205
1334590920000000000,7,0,124,37,38,206
1334590980000000000,7,0,122,36,37,202
1334591040000000000,7,0,122,37,38,204
1334591100000000000,7,0,0,36,37,80
1334591160000000000,7,0,0,36,38,81
1334591220000000000,7,0,0,36,37,80
1334591280000000000,7,0,0,36,38,81
1334591340000000000,7,0,0,36,38,81
1334591400000000000,7,0,0,38,38,83
1334591460000000000,7,0,0,37,38,82
1334591520000000000,7,0,1,37,38,83
1334591580000000000,7,0,1,38,38,84
1334591640000000000,7,0,0,36,37,80
1334591700000000000,7,0,1,37,38,83
1334591760000000000,7,0,1,36,37,81
1334591820000000000,7,0,0,36,38,81
1334591880000000000,7,0,0,37,38,82
1334591940000000000,7,0,1,36,38,82
1334592000000000000,7,0,0,1076,38,1121
1334592060000000000,7,0,1,1590,38,1636
1334592120000000000,7,0,0,1706,38,1751
1334592180000000000,329,0,0,1759,38,2126
1334592240000000000,329,0,0,1779,37,2145
1334592300000000000,329,0,0,1763,38,2130
1334592360000000000,7,0,1,1776,38,1822
1334592420000000000,7,0,0,1781,38,1826
1334592480000000000,7,0,0,1791,38,1836
1334592540000000000,7,0,0,1790,38,1835
1334592600000000000,7,0,0,1800,38,1845
1334592660000000000,7,0,10,1801,38,1856
1334592720000000000,7,0,1,1808,38,1854
1334592780000000000,7,0,0,1810,38,1855
1334592840000000000,7,0,0,1816,38,1861
1334592900000000000,7,0,0,1818,37,1862
1334592960000000000,7,0,149,1821,38,2015
1334593020000000000,7,0,133,1829,38,2007
1334593080000000000,7,0,128,1832,38,2005
1334593140000000000,7,0,130,1838,38,2013
1334593200000000000,7,0,131,1838,38,2014
1334593260000000000,7,0,131,1,37,176
1334593320000000000,7,0,131,1,38,177
1334593380000000000,7,0,130,1,38,176
1334593440000000000,7,0,130,1,38,176
1334593500000000000,7,0,129,1,38,175
1334593560000000000,7,0,129,1,38,175
1334593620000000000,7,0,129,1,38,175
1334593680000000000,7,0,129,1,38,175
1334593740000000000,7,0,129,1,39,176
1334593800000000000,7,0,128,1,38,174
1334593860000000000,7,0,7,1,38,53
1334593920000000000,7,0,7,1,38,53
1334593980000000000,7,0,7,1,39,54
1334594040000000000,7,0,7,1,37,52
1334594100000000000,7,0,7,1,38,53
1334594160000000000,7,0,7,1,38,53
1334594220000000000,7,0,7,0,38,52
1334594280000000000,7,0,7,1,38,53
1334594340000000000,7,0,7,0,38,52
1334594400000000000,7,0,157,38,38,240
1334594460000000000,7,0,142,37,38,224
1334594520000000000,7,0,136,36,38,217
1334594580000000000,7,0,135,37,38,217
1334594640000000000,7,0,134,36,37,214
1334594700000000000,7,0,133,36,38,214
1334594760000000000,7,0,132,37,38,214
1334594820000000000,7,0,131,37,38,213
1334594880000000000,7,0,131,37,37,212
1334594940000000000,7,0,132,37,38,214
1334595000000000000,7,0,129,38,37,211
1334595060000000000,7,0,127,36,37,207
1334595120000000000,7,0,124,36,38,205
1334595180000000000,7,0,124,37,38,206
1334595240000000000,7,0,123,37,37,204
1334595300000000000,7,0,0,36,38,81
1334595360000000000,7,0,0,36,38,81
1334595420000000000,7,0,1,37,38,83
1334595480000000000,7,0,0,37,38,82
1334595540000000000,7,0,0,38,38,83
1334595600000000000,336,0,0,36,37,409
1334595660000000000,7,0,0,37,39,83
1334595720000000000,7,0,0,37,38,82
1334595780000000000,7,0,0,36,38,81
1334595840000000000,7,0,0,38,38,83
1334595900000000000,7,0,0,37,38,82
1334595960000000000,7,0,0,37,38,82
1334596020000000000,7,0,1,36,38,82
1334596080000000000,7,0,0,37,38,82
1334596140000000000,7,0,0,36,38,81
1334596200000000000,7,0,0,37,39,83
1334596260000000000,7,0,0,38,38,83
1334596320000000000,7,0,0,38,38,83
1334596380000000000,7,0,0,36,38,81
1334596440000000000,7,0,0,36,38,81
1334596500000000000,7,0,0,37,38,82
1334596560000000000,7,0,1,38,37,83
1334596620000000000,7,0,81,38,38,164
1334596680000000000,7,0,0,36,38,81
1334596740000000000,7,0,0,36,39,82
1334596800000000000,7,0,0,1484,38,1529
1334596860000000000,7,0,0,1659,37,1703
1334596920000000000,7,0,0,1750,38,1795
1334596980000000000,7,0,1,1786,38,1832
1334597040000000000,7,0,0,1771,38,1816
1334597100000000000,7,0,0,1783,37,1827
1334597160000000000,7,0,0,1800,37,1844
1334597220000000000,7,0,128,1810,38,1983
1334597280000000000,7,0,140,1811,38,1996
1334597340000000000,7,0,128,1817,38,1990
1334597400000000000,7,0,127,1816,38,1988
1334597460000000000,7,0,126,1827,38,1998
1334597520000000000,7,0,125,1831,38,2001
1334597580000000000,7,0,125,1831,38,2001
1334597640000000000,7,0,124,1835,38,2004
1334597700000000000,7,0,123,1832,38,2000
1334597760000000000,7,0,122,1839,38,2006
1334597820000000000,7,0,0,1,38,46
1334597880000000000,7,0,1,1,38,47
1334597940000000000,7,0,0,1,38,46
1334598000000000000,7,0,0,0,38,45
1334598060000000000,7,0,0,1,38,46
1334598120000000000,7,0,0,1,38,46
1334598180000000000,7,0,0,1,38,46
1334598240000000000,7,0,0,1,38,46
1334598300000000000,7,0,0,1,37,45
1334598360000000000,7,0,1,1,38,47
1334598420000000000,7,0,0,1,38,46
1334598480000000000,7,0,0,1,38,46
1334598540000000000,7,0,0,1,38,46
1334598600000000000,7,0,7,1,38,53
1334598660000000000,7,0,7,1,38,53
1334598720000000000,7,0,7,0,38,52
1334598780000000000,7,0,7,1,37,52
1334598840000000000,7,0,7,1,38,53
1334598900000000000,7,0,7,38,38,90
1334598960000000000,7,0,7,37,38,89
1334599020000000000,7,0,148,37,38,230
1334599080000000000,7,0,138,37,38,220
1334599140000000000,7,0,137,36,38,218
1334599200000000000,7,0,136,36,38,217
1334599260000000000,7,0,135,36,38,216
1334599320000000000,7,0,134,36,37,214
1334599380000000000,7,0,133,36,38,214
1334599440000000000,7,0,132,37,39,215
1334599500000000000,7,0,131,36,37,211
1334599560000000000,7,0,131,36,37,211
1334599620000000000,7,0,132,36,38,213
1334599680000000000,7,0,138,35,38,218
1334599740000000000,7,0,135,36,38,216
1334599800000000000,7,0,135,36,37,215
1334599860000000000,7,0,134,36,38,215
1334599920000000000,7,0,132,36,37,212
1334599980000000000,7,0,132,36,37,212
1334600040000000000,7,0,131,36,38,212
1334600100000000000,7,0,130,36,39,212
1334600160000000000,7,0,131,35,38,211
1334600220000000000,7,0,131,36,37,211
1334600280000000000,7,0,130,36,37,210
1334600340000000000,7,0,129,36,38,210
1334600400000000000,7,0,128,35,37,207
1334600460000000000,7,0,128,36,38,209
1334600520000000000,7,0,127,36,37,207
1334600580000000000,7,0,127,36,38,208
1334600640000000000,7,0,206,36,37,286
1334600700000000000,7,0,129,36,38,210
1334600760000000000,7,0,130,36,38,211
1334600820000000000,7,0,7,36,38,88
1334600880000000000,7,0,7,36,38,88
1334600940000000000,7,0,7,37,38,89
1334601000000000000,7,0,7,35,38,87
1334601060000000000,7,0,7,36,38,88
1334601120000000000,7,0,0,37,37,81
1334601180000000000,7,0,0,35,38,80
1334601240000000000,7,0,0,37,37,81
1334601300000000000,7,0,0,36,37,80
1334601360000000000,7,0,133,36,38,214
1334601420000000000,7,0,142,36,38,223
1334601480000000000,7,0,131,35,38,211
1334601540000000000,7,0,128,37,37,209
1334601600000000000,7,0,128,36,39,210
1334601660000000000,7,0,125,36,38,206
1334601720000000000,7,0,124,37,38,206
1334601780000000000,7,0,123,36,38,204
1334601840000000000,7,0,122,35,38,202
1334601900000000000,7,0,122,36,38,203
1334601960000000000,7,0,121,37,38,203
1334602020000000000,7,0,0,36,38,81
1334602080000000000,7,0,0,36,38,81
1334602140000000000,7,0,0,36,38,81
1334602200000000000,7,0,0,37,38,82
1334602260000000000,7,0,0,37,38,82
1334602320000000000,7,0,0,37,38,82
1334602380000000000,7,0,1,36,38,82
1334602440000000000,7,0,0,36,38,81
1334602500000000000,7,0,0,36,38,81
1334602560000000000,7,0,0,37,37,81
1334602620000000000,7,0,0,37,38,82
1334602680000000000,7,0,0,36,37,80
1334602740000000000,7,0,0,37,38,82
1334602800000000000,7,0,0,37,38,82
1334602860000000000,7,0,0,36,38,81
1334602920000000000,7,0,0,36,38,81
1334602980000000000,7,0,0,37,38,82
1334603040000000000,7,0,0,38,38,83
1334603100000000000,7,0,0,37,37,81
1334603160000000000,7,0,0,37,38,82
1334603220000000000,7,0,0,35,38,80
1334603280000000000,7,0,0,38,37,82
1334603340000000000,7,0,0,37,38,82
1334603400000000000,7,0,0,37,38,82
1334603460000000000,7,0,0,36,38,81
1334603520000000000,7,0,0,37,38,82
1334603580000000000,7,0,0,36,38,81
1334603640000000000,7,0,0,37,38,82
1334603700000000000,7,0,1,38,38,84
1334603760000000000,7,0,0,37,39,83
1334603820000000000,7,0,0,36,38,81
1334603880000000000,7,0,0,37,37,81
1334603940000000000,7,0,0,37,38,82
1334604000000000000,7,0,135,38,38,218
1334604060000000000,7,0,139,36,38,220
1334604120000000000,7,0,129,36,38,210
1334604180000000000,7,0,127,37,37,208
1334604240000000000,7,0,126,37,38,208
1334604300000000000,7,0,126,37,38,208
1334604360000000000,7,0,125,37,38,207
1334604420000000000,7,0,123,36,37,203
1334604480000000000,7,0,124,36,38,205
1334604540000000000,7,0,123,37,38,205
1334604600000000000,7,0,0,38,38,83
1334604660000000000,7,0,7,37,38,89
1334604720000000000,7,0,0,38,37,82
1334604780000000000,7,0,0,38,38,83
1334604840000000000,7,0,0,37,38,82
1334604900000000000,7,0,0,37,39,83
1334604960000000000,7,0,0,37,38,82
1334605020000000000,7,0,1,36,38,82
1334605080000000000,7,0,0,37,38,82
1334605140000000000,7,0,0,38,38,83
1334605200000000000,7,0,0,38,37,82
1334605260000000000,7,0,0,37,38,82
1334605320000000000,7,0,0,36,38,81
1334605380000000000,7,0,0,36,38,81
1334605440000000000,7,0,0,35,38,80
1334605500000000000,7,0,0,37,38,82
1334605560000000000,7,0,0,36,38,81
1334605620000000000,7,0,0,36,38,81
1334605680000000000,7,0,0,36,38,81
1334605740000000000,7,0,0,36,38,81
1334605800000000000,7,0,1,37,37,82
1334605860000000000,7,0,0,36,38,81
1334605920000000000,7,0,1,37,37,82
1334605980000000000,7,0,0,37,38,82
1334606040000000000,7,0,0,37,38,82
1334606100000000000,7,0,1,36,38,82
1334606160000000000,7,0,0,38,38,83
1334606220000000000,7,0,0,37,38,82
1334606280000000000,7,0,148,36,38,229
1334606340000000000,7,0,136,36,38,217
1334606400000000000,7,0,127,37,38,209
1334606460000000000,7,0,127,36,38,208
1334606520000000000,7,0,126,38,38,209
1334606580000000000,7,0,124,36,37,204
1334606640000000000,7,0,124,38,37,206
1334606700000000000,7,0,123,37,38,205
1334606760000000000,7,0,122,36,38,203
1334606820000000000,7,0,122,37,38,204
1334606880000000000,7,0,0,37,38,82
1334606940000000000,7,0,0,35,37,79
1334607000000000000,7,0,0,36,38,81
1334607060000000000,7,0,0,37,38,82
1334607120000000000,7,0,0,37,38,82
1334607180000000000,7,0,0,36,38,81
1334607240000000000,7,0,0,37,38,82
1334607300000000000,7,0,0,36,38,81
1334607360000000000,7,0,0,37,38,82
1334607420000000000,7,0,0,37,37,81
1334607480000000000,7,0,0,1564,38,1609
1334607540000000000,7,0,0,1679,38,1724
1334607600000000000,7,0,0,1751,38,1796
1334607660000000000,7,0,0,1783,38,1828
1334607720000000000,7,0,0,1766,38,1811
1334607780000000000,7,0,0,1778,38,1823
1334607840000000000,7,0,1,1777,37,1822
1334607900000000000,7,0,1,1792,37,1837
1334607960000000000,7,0,1,1809,37,1854
1334608020000000000,7,0,1,1803,37,1848
1334608080000000000,7,0,1,1814,37,1859
1334608140000000000,7,0,1,1817,37,1862
1334608200000000000,7,0,1,1816,38,1862
1334608260000000000,7,0,0,1823,38,1868
1334608320000000000,7,0,10,1826,38,1881
1334608380000000000,7,0,0,1831,37,1875
1334608440000000000,7,0,0,1063,38,1108
1334608500000000000,7,0,0,1,38,46
1334608560000000000,7,0,0,1,38,46
1334608620000000000,7,0,0,1,38,46
1334608680000000000,7,0,148,1,37,193
1334608740000000000,7,0,136,1,38,182
1334608800000000000,7,0,133,1,38,179
1334608860000000000,7,0,131,1,38,177
1334608920000000000,7,0,132,1,37,177
1334608980000000000,7,0,131,1,38,177
1334609040000000000,7,0,131,1,38,177
1334609100000000000,7,0,131,1,38,177
1334609160000000000,7,0,130,1,38,176
1334609220000000000,7,0,130,1,38,176
1334609280000000000,7,0,130,1,38,176
1334609340000000000,7,0,130,1,37,175
1334609400000000000,7,0,129,1,37,174
1334609460000000000,7,0,129,1,38,175
1334609520000000000,7,0,129,1,38,175
1334609580000000000,7,0,128,1,38,174
1334609640000000000,7,0,7,1,38,53
1334609700000000000,7,0,7,1,39,54
1334609760000000000,7,0,7,38,38,90
1334609820000000000,7,0,7,39,38,91
1334609880000000000,7,0,7,38,38,90
1334609940000000000,7,0,7,37,38,89
1334610000000000000,7,0,7,37,38,89
1334610060000000000,7,0,7,38,37,89
1334610120000000000,7,0,7,37,38,89
1334610180000000000,7,0,156,36,37,236
1334610240000000000,7,0,140,36,38,221
1334610300000000000,7,0,136,37,38,218
1334610360000000000,7,0,135,36,39,217
1334610420000000000,7,0,135,36,38,216
1334610480000000000,7,0,134,38,38,217
1334610540000000000,7,0,133,36,38,214
1334610600000000000,7,0,135,38,38,218
1334610660000000000,7,0,129,37,38,211
1334610720000000000,7,0,127,38,38,210
1334610780000000000,7,0,125,37,38,207
1334610840000000000,7,0,124,37,37,205
1334610900000000000,7,0,124,38,38,207
1334610960000000000,7,0,122,36,38,203
1334611020000000000,7,0,0,36,38,81
1334611080000000000,7,0,0,37,38,82
1334611140000000000,7,0,0,38,38,83
1334611200000000000,7,0,0,37,38,82
1334611260000000000,7,0,0,37,38,82
1334611320000000000,7,0,0,38,38,83
1334611380000000000,7,0,0,37,38,82
1334611440000000000,7,0,0,37,38,82
1334611500000000000,7,0,0,36,38,81
1334611560000000000,7,0,0,38,38,83
1334611620000000000,7,0,0,37,38,82
1334611680000000000,7,0,0,36,37,80
1334611740000000000,7,0,0,37,38,82
1334611800000000000,7,0,0,37,38,82
1334611860000000000,7,0,0,36,38,81
1334611920000000000,7,0,0,38,37,82
1334611980000000000,7,0,0,37,38,82
1334612040000000000,7,0,0,37,38,82
1334612100000000000,7,0,0,37,38,82
1334612160000000000,7,0,0,37,38,82
1334612220000000000,7,0,0,36,38,81
1334612280000000000,7,0,0,38,38,83
1334612340000000000,7,0,0,38,37,82
1334612400000000000,7,0,0,37,38,82
1334612460000000000,7,0,0,38,38,83
1334612520000000000,7,0,0,36,38,81
1334612580000000000,7,0,1,37,38,83
1334612640000000000,7,0,0,38,38,83
1334612700000000000,7,0,0,37,38,82
1334612760000000000,7,0,0,37,38,82
1334612820000000000,7,0,0,36,38,81
1334612880000000000,7,0,0,38,38,83
1334612940000000000,7,0,0,38,38,83
1334613000000000000,7,0,147,36,38,228
1334613060000000000,7,0,133,37,38,215
1334613120000000000,7,0,129,36,38,210
1334613180000000000,7,0,128,36,38,209
1334613240000000000,7,0,126,38,38,209
1334613300000000000,7,0,125,38,38,208
1334613360000000000,7,0,124,37,38,206
1334613420000000000,7,0,123,38,38,206
1334613480000000000,7,0,123,37,38,205
1334613540000000000,7,0,122,36,38,203
1334613600000000000,7,0,0,37,38,82
1334613660000000000,7,0,0,37,38,82
1334613720000000000,7,0,1,37,38,83
1334613780000000000,7,0,0,37,38,82
1334613840000000000,7,0,1,37,38,83
1334613900000000000,7,0,0,37,38,82
1334613960000000000,7,0,1,37,38,83
1334614020000000000,7,0,0,38,38,83
1334614080000000000,7,0,0,38,39,84
1334614140000000000,7,0,0,37,38,82
1334614200000000000,7,0,10,36,38,91
1334614260000000000,7,0,7,37,38,89
1334614320000000000,7,0,0,38,38,83
1334614380000000000,7,0,0,38,38,83
1334614440000000000,7,0,0,38,38,83
1334614500000000000,7,0,0,37,38,82
1334614560000000000,7,0,0,37,38,82
1334614620000000000,7,0,0,38,38,83
1334614680000000000,7,0,0,37,38,82
1334614740000000000,7,0,0,38,38,83
1334614800000000000,7,0,0,37,39,83
1334614860000000000,7,0,0,37,38,82
1334614920000000000,7,0,0,37,38,82
1334614980000000000,7,0,0,38,38,83
1334615040000000000,7,0,0,38,38,83
1334615100000000000,7,0,0,37,39,83
1334615160000000000,7,0,0,36,39,82
1334615220000000000,7,0,1,38,38,84
1334615280000000000,7,0,0,37,38,82
1334615340000000000,7,0,0,37,38,82
1334615400000000000,7,0,142,37,38,224
1334615460000000000,7,0,129,36,38,210
1334615520000000000,7,0,127,37,37,208
1334615580000000000,7,0,126,36,38,207
1334615640000000000,7,0,125,37,38,207
1334615700000000000,7,0,126,37,38,208
1334615760000000000,7,0,124,37,38,206
1334615820000000000,7,0,124,38,39,208
1334615880000000000,7,0,122,36,38,203
1334615940000000000,7,0,0,37,38,82
1334616000000000000,7,0,1,37,38,83
1334616060000000000,7,0,0,36,39,82
1334616120000000000,7,0,0,37,38,82
1334616180000000000,7,0,0,37,38,82
1334616240000000000,7,0,0,37,37,81
1334616300000000000,7,0,0,37,38,82
1334616360000000000,7,0,0,36,37,80
1334616420000000000,7,0,0,37,38,82
1334616480000000000,7,0,0,37,37,81
1334616540000000000,7,0,0,37,38,82
1334616600000000000,7,0,0,37,38,82
1334616660000000000,7,0,1,37,37,82
1334616720000000000,7,0,1,36,37,81
1334616780000000000,7,0,0,36,38,81
1334616840000000000,7,0,0,37,38,82
1334616900000000000,7,0,0,37,38,82
1334616960000000000,7,0,0,37,38,82
1334617020000000000,7,0,0,38,38,83
1334617080000000000,7,0,0,37,38,82
1334617140000000000,7,0,0,37,37,81
1334617200000000000,7,0,0,37,38,82
1334617260000000000,7,0,0,37,37,81
1334617320000000000,7,0,0,36,38,81
1334617380000000000,7,0,0,36,38,81
1334617440000000000,7,0,0,36,38,81
1334617500000000000,7,0,0,37,39,83
1334617560000000000,7,0,0,37,37,81
1334617620000000000,7,0,0,37,38,82
1334617680000000000,7,0,0,38,38,83
1334617740000000000,7,0,0,37,38,82
1334617800000000000,7,0,1,36,38,82
1334617860000000000,7,0,7,37,37,88
1334617920000000000,7,0,10,37,37,91
1334617980000000000,329,0,148,36,37,550
1334618040000000000,327,0,138,36,37,538
1334618100000000000,329,0,135,38,37,539
1334618160000000000,331,0,134,36,37,538
1334618220000000000,328,0,132,36,38,534
1334618280000000000,330,0,132,36,37,535
1334618340000000000,331,0,132,36,111,610
1334618400000000000,329,0,132,36,111,608
1334618460000000000,332,0,131,37,157,657
1334618520000000000,330,0,130,37,328,825
1334618580000000000,331,0,129,36,207,703
1334618640000000000,330,0,131,36,187,684
1334618700000000000,327,0,128,36,398,889
1334618760000000000,328,0,128,36,400,892
1334618820000000000,329,0,127,37,162,655
1334618880000000000,327,0,127,37,228,719
1334618940000000000,330,0,127,36,229,722
1334619000000000000,351,0,127,36,229,743
1334619060000000000,332,0,127,36,233,728
1334619120000000000,332,0,127,36,319,814
1334619180000000000,331,0,7,37,255,630
1334619240000000000,334,0,7,37,257,635
1334619300000000000,331,0,7,36,259,633
1334619360000000000,329,0,7,36,263,635
1334619420000000000,333,0,7,37,199,576
1334619480000000000,331,0,7,37,221,596
1334619540000000000,328,0,6,37,320,691
1334619600000000000,328,0,7,36,260,631
1334619660000000000,326,0,6,37,204,573
1334619720000000000,326,0,154,36,281,797
1334619780000000000,326,0,138,36,387,887
1334619840000000000,328,0,135,37,262,762
1334619900000000000,329,0,133,36,348,846
1334619960000000000,329,0,132,37,274,772
1334620020000000000,331,0,129,36,284,780
1334620080000000000,331,0,127,36,178,672
1334620140000000000,329,0,126,37,239,731
1334620200000000000,332,0,127,37,294,790
1334620260000000000,332,0,124,36,253,745
1334620320000000000,328,0,122,37,254,741
1334620380000000000,332,0,122,37,270,761
1334620440000000000,333,0,121,37,244,735
1334620500000000000,333,0,0,37,249,619
1334620560000000000,333,0,0,38,218,589
1334620620000000000,330,0,0,36,255,621
1334620680000000000,333,0,0,37,305,675
1334620740000000000,332,0,0,36,250,618
1334620800000000000,327,0,0,37,261,625
1334620860000000000,330,0,0,36,271,637
1334620920000000000,329,0,79,37,256,701
1334620980000000000,329,0,0,37,262,628
1334621040000000000,331,0,0,37,257,625
1334621100000000000,332,0,0,37,256,625
1334621160000000000,332,0,0,36,235,603
1334621220000000000,329,0,0,37,244,610
1334621280000000000,330,0,0,37,266,633
1334621340000000000,329,0,0,37,273,639
1334621400000000000,329,0,0,37,244,610
1334621460000000000,329,0,0,37,238,604
1334621520000000000,334,0,0,37,225,596
1334621580000000000,333,0,0,38,231,602
1334621640000000000,331,0,0,37,223,591
1334621700000000000,332,0,0,36,232,600
1334621760000000000,333,0,0,37,216,586
1334621820000000000,332,0,0,37,229,598
1334621880000000000,333,0,0,36,251,620
1334621940000000000,334,0,0,37,50,421
1334622000000000000,7,0,1,37,48,93
1334622060000000000,7,0,0,37,48,92
1334622120000000000,7,0,0,37,47,91
1334622180000000000,7,0,0,37,48,92
1334622240000000000,7,0,0,37,48,92
1334622300000000000,7,0,0,36,47,90
1334622360000000000,7,0,0,37,48,92
1334622420000000000,7,0,0,36,47,90
1334622480000000000,7,0,0,37,48,92
1334622540000000000,7,0,143,36,47,233
1334622600000000000,7,0,131,36,47,221
1334622660000000000,7,0,129,36,48,220
1334622720000000000,7,0,126,37,48,218
1334622780000000000,7,0,125,37,47,216
1334622840000000000,7,0,125,36,48,216
1334622900000000000,7,0,124,36,48,215
1334622960000000000,7,0,127,36,48,218
1334623020000000000,7,0,127,37,48,219
1334623080000000000,7,0,129,37,48,221
1334623140000000000,7,0,129,37,47,220
1334623200000000000,7,0,7,36,47,97
1334623260000000000,7,0,7,37,47,98
1334623320000000000,7,0,7,36,48,98
1334623380000000000,7,0,7,37,48,99
1334623440000000000,7,0,7,37,48,99
1334623500000000000,7,0,7,36,48,98
1334623560000000000,7,0,7,37,48,99
1334623620000000000,7,0,7,36,48,98
1334623680000000000,7,0,7,36,48,98
1334623740000000000,7,0,149,37,47,240
1334623800000000000,7,0,139,36,48,230
1334623860000000000,7,0,136,37,48,228
1334623920000000000,7,0,135,36,48,226
1334623980000000000,7,0,135,35,48,225
1334624040000000000,7,0,135,37,37,216
1334624100000000000,7,0,132,36,37,212
1334624160000000000,7,0,132,36,37,212
1334624220000000000,7,0,132,38,38,215
1334624280000000000,7,0,131,37,37,212
1334624340000000000,7,0,131,36,37,211
1334624400000000000,7,0,132,36,38,213
1334624460000000000,7,0,132,36,37,212
1334624520000000000,7,0,132,37,37,213
1334624580000000000,7,0,131,36,37,211
1334624640000000000,7,0,130,37,37,211
1334624700000000000,329,0,129,37,189,684
1334624760000000000,329,0,129,36,260,754
1334624820000000000,333,0,127,35,249,744
1334624880000000000,333,0,125,36,259,753
1334624940000000000,333,0,123,38,263,757
1334625000000000000,333,0,122,36,247,738
1334625060000000000,333,0,0,36,269,638
1334625120000000000,333,0,0,37,229,599
1334625180000000000,334,0,0,37,224,595
1334625240000000000,330,0,0,36,220,586
1334625300000000000,331,0,0,37,207,575
1334625360000000000,332,0,0,36,221,589
1334625420000000000,332,0,0,37,212,581
1334625480000000000,331,0,0,37,233,601
1334625540000000000,330,0,0,36,338,704
1334625600000000000,330,0,0,37,238,605
1334625660000000000,331,0,0,36,242,609
1334625720000000000,330,0,0,36,260,626
1334625780000000000,331,0,0,36,254,621
1334625840000000000,330,0,0,37,254,621
1334625900000000000,331,0,0,37,259,627
1334625960000000000,331,0,0,36,280,647
1334626020000000000,330,0,0,37,384,751
1334626080000000000,330,0,0,37,406,773
1334626140000000000,329,0,0,36,251,616
1334626200000000000,329,0,0,37,217,583
1334626260000000000,330,0,0,35,234,599
1334626320000000000,329,0,0,37,267,633
1334626380000000000,330,0,0,38,264,632
1334626440000000000,332,0,0,36,268,636
1334626500000000000,333,0,0,36,269,638
1334626560000000000,333,0,0,36,263,632
1334626620000000000,333,0,0,38,238,609
1334626680000000000,333,0,0,37,281,651
1334626740000000000,334,0,0,36,238,608
1334626800000000000,334,0,147,37,243,761
1334626860000000000,332,0,135,36,258,761
1334626920000000000,334,0,127,37,255,753
1334626980000000000,333,0,127,36,261,757
1334627040000000000,332,0,126,38,252,748
1334627100000000000,331,0,124,36,265,756
1334627160000000000,332,0,123,36,271,762
1334627220000000000,334,0,123,36,262,755
1334627280000000000,334,0,122,37,244,737
1334627340000000000,334,0,122,36,240,732
1334627400000000000,335,0,0,37,214,586
1334627460000000000,334,0,0,36,210,580
1334627520000000000,334,0,0,36,204,574
1334627580000000000,335,0,0,37,209,581
1334627640000000000,334,0,0,37,231,602
1334627700000000000,333,0,0,37,403,773
1334627760000000000,331,0,0,37,287,655
1334627820000000000,331,0,0,37,276,644
1334627880000000000,328,0,0,37,273,638
1334627940000000000,328,0,0,36,225,589
1334628000000000000,329,0,0,37,48,414
1334628060000000000,331,0,0,36,47,414
1334628120000000000,332,0,0,37,48,417
1334628180000000000,332,0,0,36,48,416
1334628240000000000,331,0,0,36,48,415
1334628300000000000,331,0,0,37,47,415
1334628360000000000,331,0,0,35,48,414
1334628420000000000,333,0,10,36,48,427
1334628480000000000,333,0,0,36,48,417
1334628540000000000,333,0,0,37,47,417
1334628600000000000,332,0,0,36,48,416
1334628660000000000,331,0,0,35,48,414
1334628720000000000,330,0,0,36,48,414
1334628780000000000,330,0,0,36,47,413
1334628840000000000,332,0,0,36,48,416
1334628900000000000,332,0,0,35,48,415
1334628960000000000,332,0,0,36,48,416
1334629020000000000,332,0,0,37,47,416
1334629080000000000,330,0,142,36,48,556
1334629140000000000,331,0,130,36,47,544
1334629200000000000,330,0,127,38,48,543
1334629260000000000,329,0,126,36,47,538
1334629320000000000,330,0,125,36,47,538
1334629380000000000,327,0,124,35,47,533
1334629440000000000,328,0,126,38,47,539
1334629500000000000,328,0,126,36,48,538
1334629560000000000,325,0,127,35,47,534
1334629620000000000,326,0,127,36,47,536
1334629680000000000,328,0,127,36,47,538
1334629740000000000,330,0,7,38,48,423
1334629800000000000,327,0,7,36,47,417
1334629860000000000,329,0,7,35,47,418
1334629920000000000,329,0,7,36,47,419
1334629980000000000,7,0,7,36,48,98
1334630040000000000,7,0,7,36,48,98
1334630100000000000,7,0,7,37,47,98
1334630160000000000,7,0,7,36,37,87
1334630220000000000,7,0,7,36,37,87
1334630280000000000,7,0,153,35,37,232
1334630340000000000,7,0,139,36,37,219
1334630400000000000,7,0,136,36,38,217
1334630460000000000,7,0,135,36,37,215
1334630520000000000,7,0,136,37,38,218
1334630580000000000,7,0,133,36,37,213
1334630640000000000,7,0,133,36,37,213
1334630700000000000,7,0,132,36,38,213
1334630760000000000,7,0,132,35,37,211
1334630820000000000,7,0,132,36,38,213
1334630880000000000,7,0,131,35,38,211
1334630940000000000,7,0,131,37,37,212
1334631000000000000,7,0,130,35,38,210
1334631060000000000,7,0,129,36,37,209
1334631120000000000,7,0,129,36,37,209
1334631180000000000,7,0,128,36,37,208
1334631240000000000,7,0,130,37,37,211
1334631300000000000,7,0,125,36,37,205
1334631360000000000,7,0,122,36,37,202
1334631420000000000,7,0,0,36,37,80
1334631480000000000,7,0,0,36,37,80
1334631540000000000,7,0,0,36,38,81
1334631600000000000,7,0,0,36,37,80
1334631660000000000,7,0,1,36,37,81
1334631720000000000,7,0,0,36,37,80
1334631780000000000,7,0,0,36,37,80
1334631840000000000,7,0,0,36,37,80
1334631900000000000,7,0,0,36,37,80
1334631960000000000,7,0,1,36,37,81
1334632020000000000,7,0,0,37,37,81
1334632080000000000,7,0,0,36,37,80
1334632140000000000,7,0,0,37,37,81
1334632200000000000,7,0,0,36,37,80
1334632260000000000,7,0,0,36,37,80
1334632320000000000,7,0,0,38,37,82
1334632380000000000,7,0,0,36,38,81
1334632440000000000,7,0,0,36,37,80
1334632500000000000,7,0,0,37,37,81
1334632560000000000,7,0,0,36,38,81
1334632620000000000,7,0,0,35,38,80
1334632680000000000,7,0,0,37,37,81
1334632740000000000,7,0,0,36,38,81
1334632800000000000,7,0,0,35,37,79
1334632860000000000,7,0,0,36,37,80
1334632920000000000,7,0,0,36,38,81
1334632980000000000,7,0,0,36,37,80
1334633040000000000,7,0,0,36,38,81
1334633100000000000,7,0,1,36,37,81
1334633160000000000,7,0,0,35,37,79
1334633220000000000,7,0,144,36,37,224
1334633280000000000,7,0,133,36,37,213
1334633340000000000,7,0,128,38,38,211
1334633400000000000,7,0,127,37,37,208
1334633460000000000,7,0,126,36,37,206
1334633520000000000,7,0,124,36,37,204
1334633580000000000,7,0,123,36,37,203
1334633640000000000,7,0,122,38,37,204
1334633700000000000,7,0,122,36,37,202
1334633760000000000,7,0,122,37,37,203
1334633820000000000,7,0,0,38,37,82
1334633880000000000,7,0,0,36,37,80
1334633940000000000,7,0,0,37,37,81
1334634000000000000,7,0,0,37,38,82
1334634060000000000,7,0,0,36,37,80
1334634120000000000,7,0,0,37,37,81
1334634180000000000,7,0,0,36,38,81
1334634240000000000,7,0,0,37,37,81
1334634300000000000,7,0,0,37,38,82
1334634360000000000,7,0,0,37,38,82
1334634420000000000,7,0,0,36,37,80
1334634480000000000,7,0,0,37,38,82
1334634540000000000,7,0,0,37,38,82
1334634600000000000,7,0,0,37,37,81
1334634660000000000,7,0,0,37,38,82
1334634720000000000,7,0,0,37,37,81
1334634780000000000,7,0,0,36,37,80
1334634840000000000,7,0,10,36,38,91
1334634900000000000,7,0,10,37,37,91
1334634960000000000,7,0,81,36,37,161
1334635020000000000,7,0,0,38,37,82
1334635080000000000,335,0,0,37,153,525
1334635140000000000,334,0,0,36,204,574
1334635200000000000,336,0,0,37,210,583
1334635260000000000,335,0,0,37,238,610
1334635320000000000,335,0,10,36,215,596
1334635380000000000,334,0,6,36,206,582
1334635440000000000,335,0,7,36,211,589
1334635500000000000,334,0,149,37,190,710
1334635560000000000,335,0,138,37,211,721
1334635620000000000,335,0,136,36,214,721
1334635680000000000,336,0,135,36,190,697
1334635740000000000,335,0,134,37,206,712
1334635800000000000,330,0,132,35,190,687
1334635860000000000,332,0,132,36,217,717
1334635920000000000,330,0,131,37,225,723
1334635980000000000,332,0,132,36,223,723
1334636040000000000,332,0,132,35,212,711
1334636100000000000,330,0,130,37,193,690
1334636160000000000,330,0,129,35,202,696
1334636220000000000,331,0,129,36,232,728
1334636280000000000,330,0,129,36,217,712
1334636340000000000,333,0,128,36,227,724
1334636400000000000,334,0,128,37,243,742
1334636460000000000,334,0,128,37,230,729
1334636520000000000,332,0,128,36,264,760
1334636580000000000,333,0,129,37,242,741
1334636640000000000,331,0,127,38,228,724
1334636700000000000,332,0,7,37,224,600
1334636760000000000,333,0,7,36,227,603
1334636820000000000,332,0,7,36,225,600
1334636880000000000,334,0,7,37,222,600
1334636940000000000,334,0,7,36,191,568
1334637000000000000,334,0,7,36,227,604
1334637060000000000,333,0,7,37,224,601
1334637120000000000,333,0,7,37,223,600
1334637180000000000,334,0,7,36,227,604
1334637240000000000,334,0,7,37,224,602
1334637300000000000,333,0,148,36,229,746
1334637360000000000,333,0,134,36,190,693
1334637420000000000,334,0,131,36,226,727
1334637480000000000,335,0,129,37,223,724
1334637540000000000,334,0,128,37,223,722
1334637600000000000,333,0,126,37,229,725
1334637660000000000,335,0,125,37,199,696
1334637720000000000,334,0,125,37,227,723
1334637780000000000,334,0,123,37,211,705
1334637840000000000,332,0,122,36,220,710
1334637900000000000,331,0,121,36,223,711
1334637960000000000,332,0,0,36,218,586
1334638020000000000,330,0,0,37,210,577
1334638080000000000,329,0,0,36,217,582
1334638140000000000,332,0,0,37,232,601
1334638200000000000,332,0,0,38,232,602
1334638260000000000,329,0,0,36,226,591
1334638320000000000,329,0,0,36,230,595
1334638380000000000,328,0,0,36,219,583
1334638440000000000,329,0,0,36,222,587
1334638500000000000,329,0,0,37,227,593
1334638560000000000,329,0,0,36,222,587
1334638620000000000,329,0,0,36,225,590
1334638680000000000,330,0,0,36,228,594
1334638740000000000,331,0,0,37,271,639
1334638800000000000,331,0,0,37,239,607
1334638860000000000,332,0,0,36,216,584
1334638920000000000,333,0,0,38,227,598
1334638980000000000,333,0,0,38,228,599
1334639040000000000,334,0,0,36,244,614
1334639100000000000,333,0,0,38,227,598
1334639160000000000,334,0,0,38,230,602
1334639220000000000,331,0,0,36,221,588
1334639280000000000,332,0,0,37,225,594
1334639340000000000,332,0,0,37,225,594
1334639400000000000,331,0,0,36,205,572
1334639460000000000,331,0,0,37,219,587
1334639520000000000,331,0,0,37,221,589
1334639580000000000,328,0,0,37,249,614
1334639640000000000,328,0,0,37,242,607
1334639700000000000,327,0,0,36,253,616
1334639760000000000,329,0,0,36,228,593
1334639820000000000,329,0,0,37,244,610
1334639880000000000,333,0,0,36,226,595
1334639940000000000,334,0,0,37,223,594
1334640000000000000,333,0,147,37,232,749
1334640060000000000,333,0,136,36,228,733
1334640120000000000,333,0,129,36,216,714
1334640180000000000,333,0,126,37,193,689
1334640240000000000,333,0,126,36,196,691
1334640300000000000,333,0,125,1639,230,2327
1334640360000000000,334,0,124,1663,230,2351
1334640420000000000,334,0,123,1698,224,2379
1334640480000000000,334,0,122,1747,225,2428
1334640540000000000,333,0,121,1759,228,2441
1334640600000000000,334,0,0,1747,228,2309
1334640660000000000,335,0,0,1750,226,2311
1334640720000000000,335,0,0,1747,241,2323
1334640780000000000,337,0,0,1765,245,2347
1334640840000000000,337,0,0,1767,258,2362
1334640900000000000,338,0,10,1782,247,2377
1334640960000000000,338,0,0,1778,230,2346
1334641020000000000,338,0,0,1768,239,2345
1334641080000000000,338,0,0,1798,247,2383
1334641140000000000,338,0,0,1787,234,2359
1334641200000000000,338,0,0,1795,249,2382
1334641260000000000,338,0,0,1794,242,2374
1334641320000000000,342,0,0,1,237,580
1334641380000000000,334,0,0,1,241,576
1334641440000000000,334,0,0,0,225,559
1334641500000000000,334,0,0,0,227,561
1334641560000000000,335,0,0,1,244,580
1334641620000000000,335,0,0,1,230,566
1334641680000000000,335,0,0,1,258,594
1334641740000000000,334,0,0,1,215,550
1334641800000000000,334,0,0,0,181,515
1334641860000000000,334,0,0,0,265,599
1334641920000000000,334,0,0,0,302,636
1334641980000000000,334,0,0,1,248,583
1334642040000000000,334,0,0,1,305,640
1334642100000000000,334,0,0,1,246,581
1334642160000000000,333,0,0,0,246,579
1334642220000000000,333,0,0,0,291,624
1334642280000000000,334,0,0,0,277,611
1334642340000000000,333,0,0,39,317,689
1334642400000000000,334,0,142,38,237,751
1334642460000000000,334,0,138,37,237,746
1334642520000000000,332,0,128,36,274,770
1334642580000000000,332,0,127,37,240,736
1334642640000000000,333,0,126,37,230,726
1334642700000000000,334,0,125,36,241,736
1334642760000000000,334,0,124,36,244,738
1334642820000000000,334,0,123,37,227,721
1334642880000000000,334,0,122,37,244,737
1334642940000000000,334,0,122,37,246,739
1334643000000000000,333,0,0,37,228,598
1334643060000000000,331,0,0,36,242,609
1334643120000000000,330,0,0,37,48,415
1334643180000000000,7,0,0,36,48,91
1334643240000000000,7,0,0,38,48,93
1334643300000000000,7,0,0,36,48,91
1334643360000000000,7,0,10,38,48,103
1334643420000000000,7,0,7,36,48,98
1334643480000000000,7,0,7,38,37,89
1334643540000000000,7,0,7,38,37,89
1334643600000000000,7,0,7,38,38,90
1334643660000000000,7,0,7,37,37,88
1334643720000000000,7,0,7,37,37,88
1334643780000000000,7,0,7,37,37,88
1334643840000000000,7,0,7,38,39,91
1334643900000000000,7,0,153,38,39,237
1334643960000000000,7,0,143,38,38,226
1334644020000000000,7,0,138,35,38,218
1334644080000000000,7,0,137,35,38,217
1334644140000000000,7,0,135,38,38,218
1334644200000000000,7,0,133,36,38,214
1334644260000000000,7,0,134,36,38,215
1334644320000000000,7,0,133,36,38,214
1334644380000000000,7,0,132,36,38,213
1334644440000000000,7,0,132,38,38,215
1334644500000000000,7,0,131,37,39,214
1334644560000000000,7,0,131,38,38,214
1334644620000000000,7,0,129,37,38,211
1334644680000000000,7,0,129,37,38,211
1334644740000000000,7,0,128,37,37,209
1334644800000000000,7,0,129,36,37,209
1334644860000000000,7,0,128,38,38,211
1334644920000000000,7,0,128,1481,38,1654
1334644980000000000,7,0,129,1663,38,1837
1334645040000000000,7,0,130,1722,38,1897
1334645100000000000,7,0,7,1757,38,1809
1334645160000000000,7,0,7,1761,38,1813
1334645220000000000,7,0,7,1771,38,1823
1334645280000000000,7,0,0,1779,38,1824
1334645340000000000,7,0,0,1751,38,1796
1334645400000000000,7,0,0,1762,39,1808
1334645460000000000,7,0,0,1761,38,1806
1334645520000000000,7,0,0,1762,38,1807
1334645580000000000,7,0,0,1775,38,1820
1334645640000000000,7,0,1,1779,38,1825
1334645700000000000,7,0,0,1776,38,1821
1334645760000000000,7,0,0,1779,38,1824
1334645820000000000,7,0,0,1774,38,1819
1334645880000000000,7,0,0,1789,38,1834
1334645940000000000,7,0,1,1793,38,1839
1334646000000000000,7,0,146,1785,38,1976
1334646060000000000,7,0,131,1797,37,1972
1334646120000000000,7,0,128,1,38,174
1334646180000000000,7,0,128,1,38,174
1334646240000000000,7,0,126,0,38,171
1334646300000000000,7,0,124,1,38,170
1334646360000000000,7,0,124,1,38,170
1334646420000000000,7,0,123,1,38,169
1334646480000000000,7,0,124,1,38,170
1334646540000000000,7,0,1,1,38,47
1334646600000000000,7,0,0,1,38,46
1334646660000000000,7,0,0,1,39,47
1334646720000000000,7,0,0,1,38,46
1334646780000000000,7,0,0,1,37,45
1334646840000000000,7,0,0,1,39,47
1334646900000000000,7,0,0,1,38,46
1334646960000000000,7,0,0,0,37,44
1334647020000000000,7,0,0,1,38,46
1334647080000000000,7,0,0,0,38,45
1334647140000000000,7,0,0,1,38,46
1334647200000000000,7,0,0,39,38,84
1334647260000000000,7,0,0,39,38,84
1334647320000000000,7,0,1,38,38,84
1334647380000000000,7,0,0,38,37,82
1334647440000000000,7,0,0,38,38,83
1334647500000000000,7,0,0,38,38,83
1334647560000000000,7,0,0,37,38,82
1334647620000000000,7,0,0,37,38,82
1334647680000000000,7,0,0,37,38,82
1334647740000000000,7,0,0,37,38,82
1334647800000000000,7,0,1,38,38,84
1334647860000000000,7,0,0,38,38,83
1334647920000000000,7,0,0,38,38,83
1334647980000000000,7,0,0,37,38,82
1334648040000000000,7,0,1,37,39,84
1334648100000000000,7,0,0,38,39,84
1334648160000000000,7,0,0,38,38,83
1334648220000000000,7,0,1,36,38,82
1334648280000000000,7,0,0,37,38,82
1334648340000000000,7,0,0,38,38,83
1334648400000000000,7,0,0,37,39,83
1334648460000000000,7,0,1,37,38,83
1334648520000000000,7,0,0,37,38,82
1334648580000000000,7,0,0,38,39,84
1334648640000000000,7,0,0,36,38,81
1334648700000000000,7,0,139,38,39,223
1334648760000000000,7,0,139,37,38,221
1334648820000000000,7,0,130,36,39,212
1334648880000000000,7,0,129,37,38,211
1334648940000000000,7,0,127,1553,38,1725
1334649000000000000,7,0,126,1701,38,1872
1334649060000000000,7,0,125,1738,38,1908
1334649120000000000,7,0,124,1753,37,1921
1334649180000000000,7,0,122,1771,38,1938
1334649240000000000,7,0,123,1741,38,1909
1334649300000000000,7,0,122,1753,38,1920
1334649360000000000,7,0,1,1761,38,1807
1334649420000000000,7,0,0,1769,38,1814
1334649480000000000,7,0,0,1768,38,1813
1334649540000000000,7,0,0,1774,38,1819
1334649600000000000,7,0,0,1783,38,1828
1334649660000000000,7,0,0,1782,38,1827
1334649720000000000,7,0,0,1784,39,1830
1334649780000000000,7,0,0,1787,39,1833
1334649840000000000,7,0,0,1794,38,1839
1334649900000000000,7,0,0,1793,38,1838
1334649960000000000,7,0,0,1795,38,1840
1334650020000000000,7,0,0,1797,39,1843
1334650080000000000,7,0,0,1797,38,1842
1334650140000000000,7,0,0,0,38,45
1334650200000000000,7,0,0,1,38,46
1334650260000000000,7,0,1,1,38,47
1334650320000000000,7,0,0,1,38,46
1334650380000000000,7,0,0,1,38,46
1334650440000000000,7,0,0,0,38,45
1334650500000000000,7,0,0,1,38,46
1334650560000000000,7,0,0,1,38,46
1334650620000000000,7,0,0,0,38,45
1334650680000000000,7,0,1,1,38,47
1334650740000000000,7,0,0,1,37,45
1334650800000000000,7,0,0,1,38,46
1334650860000000000,7,0,0,1,38,46
1334650920000000000,7,0,1,1,39,48
1334650980000000000,7,0,0,1,38,46
1334651040000000000,7,0,0,1,38,46
1334651100000000000,7,0,0,1,38,46
1334651160000000000,7,0,0,1,38,46
1334651220000000000,7,0,0,39,38,84
1334651280000000000,7,0,0,39,38,84
1334651340000000000,7,0,0,38,39,84
1334651400000000000,7,0,0,38,38,83
1334651460000000000,7,0,147,38,38,230
1334651520000000000,7,0,135,38,38,218
1334651580000000000,7,0,128,38,38,211
1334651640000000000,7,0,127,38,37,209
1334651700000000000,7,0,126,37,39,209
1334651760000000000,7,0,125,38,39,209
1334651820000000000,7,0,125,38,37,207
1334651880000000000,7,0,125,38,38,208
1334651940000000000,7,0,124,38,38,207
1334652000000000000,7,0,124,38,38,207
1334652060000000000,7,0,0,36,38,81
1334652120000000000,7,0,0,38,38,83
1334652180000000000,7,0,0,38,38,83
1334652240000000000,7,0,0,38,38,83
1334652300000000000,7,0,0,38,38,83
1334652360000000000,7,0,0,37,38,82
1334652420000000000,7,0,0,1330,38,1375
1334652480000000000,7,0,10,1625,38,1680
1334652540000000000,7,0,0,1721,38,1766
1334652600000000000,7,0,0,1746,38,1791
1334652660000000000,7,0,1,1767,38,1813
1334652720000000000,7,0,0,1777,38,1822
1334652780000000000,7,0,0,1747,38,1792
1334652840000000000,7,0,0,1755,38,1800
1334652900000000000,7,0,0,1766,39,1812
1334652960000000000,7,0,0,1770,37,1814
1334653020000000000,7,0,0,1771,39,1817
1334653080000000000,7,0,0,1776,38,1821
1334653140000000000,7,0,0,1785,38,1830
1334653200000000000,7,0,0,1787,38,1832
1334653260000000000,7,0,0,1785,38,1830
1334653320000000000,7,0,0,1791,38,1836
1334653380000000000,7,0,1,1791,38,1837
1334653440000000000,7,0,0,1797,38,1842
1334653500000000000,7,0,0,1799,38,1844
1334653560000000000,7,0,0,1794,38,1839
1334653620000000000,7,0,0,1799,38,1844
1334653680000000000,7,0,0,1802,38,1847
1334653740000000000,7,0,0,1,38,46
1334653800000000000,7,0,0,1,38,46
1334653860000000000,7,0,0,1,38,46
1334653920000000000,7,0,148,1,37,193
1334653980000000000,7,0,137,0,38,182
1334654040000000000,7,0,133,1,38,179
1334654100000000000,7,0,135,1,38,181
1334654160000000000,7,0,132,1,37,177
1334654220000000000,7,0,132,1,38,178
1334654280000000000,7,0,131,1,38,177
1334654340000000000,7,0,131,1,38,177
1334654400000000000,7,0,130,1,38,176
1334654460000000000,7,0,131,1,38,177
1334654520000000000,7,0,130,1,38,176
1334654580000000000,7,0,131,1,38,177
1334654640000000000,7,0,129,42,38,216
1334654700000000000,7,0,130,38,38,213
1334654760000000000,7,0,129,38,38,212
1334654820000000000,7,0,129,38,38,212
1334654880000000000,7,0,128,38,39,212
1334654940000000000,7,0,7,37,38,89
1334655000000000000,7,0,7,38,38,90
1334655060000000000,7,0,7,38,38,90
1334655120000000000,7,0,7,37,37,88
1334655180000000000,7,0,7,38,38,90
1334655240000000000,7,0,7,38,38,90
1334655300000000000,7,0,7,38,38,90
1334655360000000000,7,0,7,38,38,90
1334655420000000000,7,0,7,38,38,90
1334655480000000000,7,0,7,38,38,90
1334655540000000000,7,0,151,38,38,234
1334655600000000000,7,0,137,38,38,220
1334655660000000000,7,0,133,38,37,215
1334655720000000000,7,0,131,37,38,213
1334655780000000000,7,0,129,38,38,212
1334655840000000000,7,0,127,1439,38,1611
1334655900000000000,7,0,127,1650,38,1822
1334655960000000000,7,0,125,1725,37,1894
1334656020000000000,7,0,124,1745,37,1913
1334656080000000000,7,0,123,1761,38,1929
1334656140000000000,7,0,122,1775,39,1943
1334656200000000000,7,0,0,1790,38,1835
1334656260000000000,7,0,0,1747,37,1791
1334656320000000000,7,0,0,1762,38,1807
1334656380000000000,7,0,0,1766,38,1811
1334656440000000000,7,0,0,1773,38,1818
1334656500000000000,7,0,0,1777,38,1822
1334656560000000000,7,0,0,1781,38,1826
1334656620000000000,7,0,1,1778,38,1824
1334656680000000000,7,0,0,1787,38,1832
1334656740000000000,7,0,0,1790,38,1835
1334656800000000000,7,0,0,1792,38,1837
1334656860000000000,7,0,0,1794,38,1839
1334656920000000000,7,0,0,1797,38,1842
1334656980000000000,7,0,0,1797,38,1842
1334657040000000000,7,0,0,1800,38,1845
1334657100000000000,7,0,0,1801,39,1847
1334657160000000000,7,0,1,1,38,47
1334657220000000000,7,0,0,0,38,45
1334657280000000000,7,0,1,1,39,48
1334657340000000000,7,0,0,1,38,46
1334657400000000000,7,0,0,1,38,46
1334657460000000000,7,0,0,1,38,46
1334657520000000000,7,0,0,1,38,46
1334657580000000000,7,0,0,1,38,46
1334657640000000000,7,0,0,1,38,46
1334657700000000000,7,0,0,1,38,46
1334657760000000000,7,0,0,1,38,46
1334657820000000000,7,0,0,1,38,46
1334657880000000000,7,0,0,1,38,46
1334657940000000000,7,0,1,0,38,46
1334658000000000000,7,0,0,1,38,46
1334658060000000000,7,0,0,39,38,84
1334658120000000000,7,0,0,38,37,82
1334658180000000000,7,0,0,39,38,84
1334658240000000000,7,0,0,38,38,83
1334658300000000000,7,0,149,38,37,231
1334658360000000000,7,0,137,37,38,219
1334658420000000000,7,0,129,38,38,212
1334658480000000000,7,0,129,37,38,211
1334658540000000000,7,0,127,37,38,209
1334658600000000000,7,0,125,38,38,208
1334658660000000000,7,0,125,38,38,208
1334658720000000000,7,0,124,38,38,207
1334658780000000000,7,0,123,38,38,206
1334658840000000000,7,0,123,38,38,206
1334658900000000000,7,0,0,37,39,83
1334658960000000000,7,0,0,38,38,83
1334659020000000000,7,0,0,38,38,83
1334659080000000000,7,0,0,37,38,82
1334659140000000000,7,0,0,37,38,82
1334659200000000000,7,0,10,38,39,94
1334659260000000000,7,0,0,37,39,83
1334659320000000000,7,0,0,37,38,82
1334659380000000000,7,0,1,38,38,84
1334659440000000000,7,0,0,38,38,83
1334659500000000000,7,0,0,38,38,83
1334659560000000000,7,0,0,38,39,84
1334659620000000000,7,0,0,37,38,82
1334659680000000000,7,0,0,37,38,82
1334659740000000000,7,0,0,38,37,82
1334659800000000000,7,0,1,38,39,85
1334659860000000000,7,0,0,1482,38,1527
1334659920000000000,7,0,0,1661,38,1706
1334659980000000000,7,0,1,1727,38,1773
1334660040000000000,7,0,0,1742,37,1786
1334660100000000000,7,0,0,1760,37,1804
1334660160000000000,7,0,0,1774,38,1819
1334660220000000000,7,0,0,1785,38,1830
1334660280000000000,7,0,0,1754,37,1798
1334660340000000000,7,0,0,1765,38,1810
1334660400000000000,7,0,0,1766,38,1811
1334660460000000000,7,0,0,1769,38,1814
1334660520000000000,7,0,0,1775,38,1820
1334660580000000000,7,0,0,1782,37,1826
1334660640000000000,7,0,1,1779,38,1825
1334660700000000000,7,0,0,1784,39,1830
1334660760000000000,7,0,1,1786,38,1832
1334660820000000000,7,0,143,1790,38,1978
1334660880000000000,7,0,131,1792,38,1968
1334660940000000000,7,0,129,1795,38,1969
1334661000000000000,7,0,128,1793,38,1966
1334661060000000000,7,0,126,1800,39,1972
1334661120000000000,7,0,125,1801,38,1971
1334661180000000000,7,0,124,1799,37,1967
1334661240000000000,7,0,124,1801,38,1970
1334661300000000000,7,0,123,1803,38,1971
1334661360000000000,7,0,0,172,38,217
1334661420000000000,7,0,0,1,38,46
1334661480000000000,7,0,0,1,38,46
1334661540000000000,7,0,0,1,38,46
1334661600000000000,7,0,0,1,38,46
1334661660000000000,7,0,0,1,38,46
1334661720000000000,7,0,1,1,38,47
1334661780000000000,7,0,1,1,37,46
1334661840000000000,7,0,0,1,38,46
1334661900000000000,7,0,0,1,38,46
1334661960000000000,7,0,0,1,38,46
1334662020000000000,7,0,0,1,38,46
1334662080000000000,7,0,0,0,39,46
1334662140000000000,7,0,0,1,38,46
1334662200000000000,7,0,0,1,38,46
1334662260000000000,7,0,0,43,38,88
1334662320000000000,7,0,0,38,38,83
1334662380000000000,7,0,0,38,38,83
1334662440000000000,7,0,0,38,38,83
1334662500000000000,7,0,1,37,38,83
1334662560000000000,7,0,0,41,38,86
1334662620000000000,7,0,0,38,38,83
1334662680000000000,7,0,0,38,38,83
1334662740000000000,7,0,0,38,38,83
1334662800000000000,7,0,10,37,38,92
1334662860000000000,7,0,10,37,38,92
1334662920000000000,7,0,0,38,38,83
1334662980000000000,7,0,1,37,38,83
1334663040000000000,7,0,0,37,38,82
1334663100000000000,7,0,0,37,38,82
1334663160000000000,7,0,0,38,38,83
1334663220000000000,7,0,141,36,38,222
1334663280000000000,7,0,141,37,38,223
1334663340000000000,7,0,130,36,38,211
1334663400000000000,7,0,128,37,38,210
1334663460000000000,7,0,127,37,38,209
1334663520000000000,7,0,127,37,38,209
1334663580000000000,7,0,127,38,39,211
1334663640000000000,7,0,124,37,38,206
1334663700000000000,7,0,123,1508,38,1676
1334663760000000000,7,0,122,1680,38,1847
1334663820000000000,7,0,0,1739,38,1784
1334663880000000000,7,0,0,1752,38,1797
1334663940000000000,7,0,0,1770,38,1815
1334664000000000000,7,0,0,1777,38,1822
1334664060000000000,7,0,0,1750,38,1795
1334664120000000000,7,0,0,1757,38,1802
1334664180000000000,7,0,10,1766,38,1821
1334664240000000000,7,0,7,1770,38,1822
1334664300000000000,7,0,7,1771,38,1823
1334664360000000000,7,0,7,1777,38,1829
1334664420000000000,7,0,7,1786,38,1838
1334664480000000000,7,0,7,1786,38,1838
1334664540000000000,7,0,7,1785,38,1837
1334664600000000000,7,0,7,1785,38,1837
1334664660000000000,7,0,7,1791,37,1842
1334664720000000000,7,0,7,1792,38,1844
1334664780000000000,7,0,148,1795,38,1988
1334664840000000000,7,0,144,1792,38,1981
1334664900000000000,7,0,137,1800,39,1983
1334664960000000000,7,0,136,1800,38,1981
1334665020000000000,7,0,134,1801,40,1982
1334665080000000000,7,0,134,1806,38,1985
1334665140000000000,7,0,133,1803,38,1981
1334665200000000000,7,0,132,1806,38,1983
1334665260000000000,7,0,132,1,38,178
1334665320000000000,7,0,132,1,38,178
1334665380000000000,7,0,132,1,38,178
1334665440000000000,7,0,131,1,38,177
1334665500000000000,7,0,130,1,38,176
1334665560000000000,7,0,132,1,38,178
1334665620000000000,7,0,129,1,38,175
1334665680000000000,7,0,129,1,37,174
1334665740000000000,7,0,129,0,38,174
1334665800000000000,7,0,128,1,39,175
1334665860000000000,7,0,128,1,38,174
1334665920000000000,7,0,127,1,38,173
1334665980000000000,7,0,0,1,38,46
1334666040000000000,7,0,0,1,38,46
1334666100000000000,7,0,0,1,38,46
1334666160000000000,7,0,0,43,38,88
1334666220000000000,7,0,0,39,39,85
1334666280000000000,7,0,0,39,38,84
1334666340000000000,7,0,0,38,38,83
1334666400000000000,7,0,0,38,38,83
1334666460000000000,7,0,1,36,37,81
1334666520000000000,7,0,0,38,38,83
1334666580000000000,7,0,0,37,38,82
1334666640000000000,7,0,0,37,38,82
1334666700000000000,7,0,0,38,38,83
1334666760000000000,7,0,0,37,38,82
1334666820000000000,7,0,0,36,38,81
1334666880000000000,7,0,1,38,38,84
1334666940000000000,7,0,0,38,38,83
1334667000000000000,7,0,0,38,38,83
1334667060000000000,7,0,0,38,38,83
1334667120000000000,7,0,0,38,38,83
1334667180000000000,7,0,1,38,38,84
1334667240000000000,7,0,1,37,38,83
1334667300000000000,7,0,0,38,38,83
1334667360000000000,7,0,0,1527,38,1572
1334667420000000000,7,0,0,1688,38,1733
1334667480000000000,7,0,0,1742,38,1787
1334667540000000000,7,0,139,1750,38,1934
1334667600000000000,7,0,140,1767,38,1952
1334667660000000000,7,0,128,1766,38,1939
1334667720000000000,7,0,128,1781,38,1954
1334667780000000000,7,0,126,1750,38,1921
1334667840000000000,7,0,125,1758,38,1928
1334667900000000000,7,0,125,1767,38,1937
1334667960000000000,7,0,123,1774,38,1942
1334668020000000000,7,0,122,1768,38,1935
1334668080000000000,7,0,122,1777,38,1944
1334668140000000000,7,0,0,1782,39,1828
1334668200000000000,7,0,0,1784,37,1828
1334668260000000000,7,0,0,1784,38,1829
1334668320000000000,7,0,0,1785,38,1830
1334668380000000000,7,0,0,1792,38,1837
1334668440000000000,7,0,0,1795,38,1840
1334668500000000000,7,0,0,1791,38,1836
1334668560000000000,7,0,0,1799,38,1844
1334668620000000000,7,0,0,1799,39,1845
1334668680000000000,7,0,0,1797,38,1842
1334668740000000000,7,0,0,1801,38,1846
1334668800000000000,7,0,0,1805,38,1850
1334668860000000000,7,0,0,1799,38,1844
1334668920000000000,7,0,0,1,38,46
1334668980000000000,7,0,1,1,38,47
1334669040000000000,7,0,0,1,38,46
1334669100000000000,7,0,0,1,38,46
1334669160000000000,7,0,1,1,39,48
1334669220000000000,7,0,0,1,38,46
1334669280000000000,7,0,0,1,38,46
1334669340000000000,7,0,0,1,38,46
1334669400000000000,7,0,0,1,39,47
1334669460000000000,7,0,0,1,38,46
1334669520000000000,7,0,7,1,38,53
1334669580000000000,7,0,0,1,38,46
1334669640000000000,7,0,1,0,38,46
1334669700000000000,7,0,0,1,39,47
1334669760000000000,7,0,0,1,38,46
1334669820000000000,7,0,0,41,38,86
1334669880000000000,7,0,0,38,38,83
1334669940000000000,7,0,0,38,38,83
1334670000000000000,7,0,0,37,38,82
1334670060000000000,7,0,147,37,38,229
1334670120000000000,7,0,134,36,38,215
1334670180000000000,7,0,128,37,38,210
1334670240000000000,8,0,127,37,38,210
1334670300000000000,7,0,126,38,38,209
1334670360000000000,7,0,125,37,38,207
1334670420000000000,7,0,124,37,38,206
1334670480000000000,7,0,125,36,38,206
1334670540000000000,7,0,122,37,38,204
1334670600000000000,7,0,122,37,38,204
1334670660000000000,7,0,0,36,38,81
1334670720000000000,7,0,1,1516,38,1562
1334670780000000000,7,0,0,1681,38,1726
1334670840000000000,7,0,0,1730,38,1775
1334670900000000000,7,0,0,1744,38,1789
1334670960000000000,7,0,0,1759,38,1804
1334671020000000000,7,0,0,1765,38,1810
1334671080000000000,7,0,0,1778,37,1822
1334671140000000000,7,0,0,1752,37,1796
1334671200000000000,7,0,0,1766,38,1811
1334671260000000000,7,0,0,1771,38,1816
1334671320000000000,7,0,1,1774,38,1820
1334671380000000000,7,0,0,1777,38,1822
1334671440000000000,7,0,0,1783,38,1828
1334671500000000000,7,0,0,1790,38,1835
1334671560000000000,7,0,0,1792,38,1837
1334671620000000000,7,0,0,1797,38,1842
1334671680000000000,7,0,0,1799,38,1844
1334671740000000000,7,0,0,1801,37,1845
1334671800000000000,7,0,0,1802,38,1847
1334671860000000000,7,0,0,1806,38,1851
1334671920000000000,7,0,0,1806,38,1851
1334671980000000000,7,0,0,1811,39,1857
1334672040000000000,7,0,0,1811,37,1855
1334672100000000000,7,0,0,1,38,46
1334672160000000000,7,0,1,1,38,47
1334672220000000000,7,0,1,1,38,47
1334672280000000000,7,0,1,1,38,47
1334672340000000000,7,0,1,1,38,47
1334672400000000000,7,0,1,1,38,47
1334672460000000000,7,0,1,1,38,47
1334672520000000000,7,0,1,1,38,47
1334672580000000000,7,0,0,1,38,46
1334672640000000000,7,0,0,1,38,46
1334672700000000000,7,0,1,1,38,47
1334672760000000000,7,0,1,0,38,46
1334672820000000000,7,0,143,1,38,189
1334672880000000000,7,0,132,1,37,177
1334672940000000000,7,0,127,1,38,173
1334673000000000000,7,0,127,0,38,172
1334673060000000000,7,0,126,1,38,172
1334673120000000000,7,0,125,39,38,209
1334673180000000000,7,0,129,38,37,211
1334673240000000000,7,0,126,37,37,207
1334673300000000000,7,0,123,37,37,204
1334673360000000000,7,0,123,37,38,205
1334673420000000000,7,0,0,37,38,82
1334673480000000000,7,0,1,38,38,84
1334673540000000000,7,0,0,38,38,83
1334673600000000000,7,0,0,36,38,81
1334673660000000000,7,0,1,36,38,82
1334673720000000000,7,0,0,36,38,81
1334673780000000000,7,0,0,37,37,81
1334673840000000000,7,0,0,36,37,80
1334673900000000000,8,0,1,37,38,84
1334673960000000000,7,0,0,37,38,82
1334674020000000000,7,0,0,37,38,82
1334674080000000000,7,0,1,37,38,83
1334674140000000000,7,0,0,36,37,80
1334674200000000000,7,0,1,36,39,83
1334674260000000000,7,0,0,36,37,80
1334674320000000000,7,0,1,37,38,83
1334674380000000000,7,0,0,1542,37,1586
1334674440000000000,7,0,0,1703,37,1747
1334674500000000000,7,0,1,1750,38,1796
1334674560000000000,7,0,0,1767,37,1811
1334674620000000000,7,0,0,1786,38,1831
1334674680000000000,7,0,1,1786,38,1832
1334674740000000000,7,0,0,1763,39,1809
1334674800000000000,7,0,0,1768,38,1813
1334674860000000000,7,0,0,1779,37,1823
1334674920000000000,7,0,0,1787,38,1832
1334674980000000000,7,0,7,1790,37,1841
1334675040000000000,7,0,7,1793,38,1845
1334675100000000000,7,0,7,1794,38,1846
1334675160000000000,7,0,7,1794,38,1846
1334675220000000000,7,0,151,1803,37,1998
1334675280000000000,7,0,140,1803,38,1988
1334675340000000000,7,0,136,1801,38,1982
1334675400000000000,7,0,134,1800,38,1979
1334675460000000000,7,0,133,1813,38,1991
1334675520000000000,7,0,133,1810,37,1987
1334675580000000000,7,0,132,1806,38,1983
1334675640000000000,7,0,133,1813,38,1991
1334675700000000000,7,0,133,1818,38,1996
1334675760000000000,7,0,133,1819,37,1996
1334675820000000000,7,0,131,2,38,178
1334675880000000000,7,0,131,1,38,177
1334675940000000000,7,0,132,2,37,178
1334676000000000000,7,0,130,2,37,176
1334676060000000000,7,0,130,2,38,177
1334676120000000000,7,0,129,1,38,175
1334676180000000000,7,0,128,1,38,174
1334676240000000000,7,0,130,1,38,176
1334676300000000000,7,0,128,1,38,174
1334676360000000000,7,0,127,1,37,172
1334676420000000000,7,0,127,1,38,173
1334676480000000000,7,0,7,0,38,52
1334676540000000000,7,0,7,1,37,52
1334676600000000000,7,0,7,1,38,53
1334676660000000000,7,0,7,1,38,53
1334676720000000000,7,7,7,1,38,60
1334676780000000000,7,0,7,1,38,53
1334676840000000000,7,0,7,0,38,52
1334676900000000000,7,0,7,38,38,90
1334676960000000000,7,0,145,38,38,228
1334677020000000000,7,0,145,37,38,227
1334677080000000000,7,0,132,38,38,215
1334677140000000000,7,0,131,38,38,214
1334677200000000000,7,0,130,37,38,212
1334677260000000000,7,0,128,38,38,211
1334677320000000000,7,0,128,37,38,210
1334677380000000000,7,0,126,37,37,207
1334677440000000000,7,0,124,37,38,206
1334677500000000000,7,0,126,36,38,207
1334677560000000000,7,0,123,37,38,205
1334677620000000000,7,0,122,38,38,205
1334677680000000000,7,0,0,36,38,81
1334677740000000000,7,0,0,37,38,82
1334677800000000000,7,0,0,38,37,82
1334677860000000000,7,0,0,38,38,83
1334677920000000000,6,0,1,38,39,84
1334677980000000000,7,0,0,36,38,81
1334678040000000000,7,0,0,38,39,84
1334678100000000000,7,0,0,36,38,81
1334678160000000000,7,0,0,37,38,82
1334678220000000000,7,0,0,37,38,82
1334678280000000000,7,0,80,38,38,163
1334678340000000000,7,0,0,37,38,82
1334678400000000000,7,0,0,37,38,82
1334678460000000000,7,0,0,37,38,82
1334678520000000000,7,0,1,37,38,83
1334678580000000000,7,0,0,38,38,83
1334678640000000000,7,0,0,37,38,82
1334678700000000000,7,0,0,36,38,81
1334678760000000000,7,0,0,36,38,81
1334678820000000000,7,0,1,38,38,84
1334678880000000000,7,0,0,37,37,81
1334678940000000000,7,0,0,36,38,81
1334679000000000000,7,0,0,37,37,81
1334679060000000000,7,0,0,36,38,81
1334679120000000000,7,0,0,37,37,81
1334679180000000000,7,0,0,36,38,81
1334679240000000000,7,0,0,38,38,83
1334679300000000000,7,0,0,37,38,82
1334679360000000000,7,0,142,37,38,224
1334679420000000000,7,0,140,36,38,221
1334679480000000000,7,0,130,37,38,212
1334679540000000000,7,0,128,36,38,209
1334679600000000000,7,0,127,36,38,208
1334679660000000000,7,0,126,37,38,208
1334679720000000000,7,0,125,36,38,206
1334679780000000000,7,0,124,37,38,206
1334679840000000000,7,0,123,38,38,206
1334679900000000000,7,0,122,38,39,206
1334679960000000000,7,0,0,36,37,80
1334680020000000000,7,0,0,37,38,82
1334680080000000000,7,0,0,36,38,81
1334680140000000000,7,0,0,36,38,81
1334680200000000000,7,0,0,36,39,82
1334680260000000000,7,0,0,37,38,82
1334680320000000000,7,0,10,37,38,92
1334680380000000000,7,0,7,36,38,88
1334680440000000000,7,0,7,37,39,90
1334680500000000000,7,0,7,1407,38,1459
1334680560000000000,7,0,7,1641,38,1693
1334680620000000000,7,0,7,1731,38,1783
1334680680000000000,7,0,7,1763,38,1815
1334680740000000000,7,0,7,1776,38,1828
1334680800000000000,7,0,7,1779,38,1831
1334680860000000000,7,0,151,1798,37,1993
1334680920000000000,7,0,140,1762,38,1947
1334680980000000000,7,0,136,1769,38,1950
1334681040000000000,7,0,136,1801,38,1982
1334681100000000000,7,0,135,1789,38,1969
1334681160000000000,7,0,134,1791,38,1970
1334681220000000000,7,0,134,1784,38,1963
1334681280000000000,7,0,133,1797,38,1975
1334681340000000000,7,0,132,1798,38,1975
1334681400000000000,7,0,132,1814,38,1991
1334681460000000000,7,0,131,1802,37,1977
1334681520000000000,7,0,130,1811,38,1986
1334681580000000000,7,0,129,1807,37,1980
1334681640000000000,7,0,130,0,37,174
1334681700000000000,7,0,129,1,39,176
1334681760000000000,7,0,127,1,38,173
1334681820000000000,7,0,130,1,38,176
1334681880000000000,7,0,128,1,38,174
1334681940000000000,7,0,128,1,38,174
1334682000000000000,7,0,127,0,38,172
1334682060000000000,7,0,129,1,38,175
1334682120000000000,7,0,7,1,38,53
1334682180000000000,7,0,7,1,38,53
1334682240000000000,7,0,7,1,38,53
1334682300000000000,7,0,7,0,38,52
1334682360000000000,7,0,0,1,38,46
1334682420000000000,7,0,0,1,38,46
1334682480000000000,7,0,0,1,38,46
1334682540000000000,7,0,0,1,38,46
1334682600000000000,7,0,0,39,38,84
1334682660000000000,7,0,0,37,37,81
1334682720000000000,7,0,0,36,38,81
1334682780000000000,7,0,0,37,38,82
1334682840000000000,7,0,0,36,38,81
1334682900000000000,7,0,147,36,38,228
1334682960000000000,7,0,132,36,38,213
1334683020000000000,7,0,128,36,38,209
1334683080000000000,7,0,127,37,38,209
1334683140000000000,7,0,125,36,39,207
1334683200000000000,7,0,125,37,38,207
1334683260000000000,7,0,123,36,38,204
1334683320000000000,7,0,124,36,37,204
1334683380000000000,7,0,122,36,38,203
1334683440000000000,7,0,121,36,37,201
1334683500000000000,7,0,0,36,38,81
1334683560000000000,7,0,0,35,38,80
1334683620000000000,7,0,0,38,38,83
1334683680000000000,7,0,0,36,38,81
1334683740000000000,7,0,0,37,38,82
1334683800000000000,7,0,0,36,38,81
1334683860000000000,7,0,0,37,38,82
1334683920000000000,7,0,0,37,38,82
1334683980000000000,7,0,0,37,38,82
1334684040000000000,7,0,0,36,38,81
1334684100000000000,7,0,0,36,39,82
1334684160000000000,7,0,0,37,38,82
1334684220000000000,7,0,1,36,37,81
1334684280000000000,7,0,0,36,38,81
1334684340000000000,7,0,0,38,38,83
1334684400000000000,7,0,0,36,38,81
1334684460000000000,7,0,0,37,38,82
1334684520000000000,7,0,0,38,38,83
1334684580000000000,7,0,1,37,38,83
1334684640000000000,7,0,0,37,38,82
1334684700000000000,7,0,0,37,38,82
1334684760000000000,7,0,0,37,38,82
1334684820000000000,7,0,0,38,38,83
1334684880000000000,7,0,0,37,38,82
1334684940000000000,7,0,0,38,38,83
1334685000000000000,7,0,0,37,38,82
1334685060000000000,7,0,0,37,38,82
1334685120000000000,7,0,80,36,38,161
1334685180000000000,7,0,0,36,38,81
1334685240000000000,7,0,0,37,38,82
1334685300000000000,7,0,0,36,38,81
1334685360000000000,7,0,0,37,37,81
1334685420000000000,7,0,0,37,38,82
1334685480000000000,7,0,0,37,38,82
1334685540000000000,7,0,1,37,38,83
1334685600000000000,7,0,144,38,38,227
1334685660000000000,7,0,134,37,38,216
1334685720000000000,7,0,130,36,38,211
1334685780000000000,7,0,127,38,38,210
1334685840000000000,7,0,127,37,38,209
1334685900000000000,7,0,127,38,38,210
1334685960000000000,7,0,127,37,39,210
1334686020000000000,7,0,126,37,38,208
1334686080000000000,7,0,125,37,38,207
1334686140000000000,7,0,123,37,38,205
1334686200000000000,7,0,124,37,38,206
1334686260000000000,7,0,0,38,39,84
1334686320000000000,7,0,0,38,38,83
1334686380000000000,7,0,0,38,37,82
1334686440000000000,7,0,0,38,38,83
1334686500000000000,7,0,0,38,38,83
1334686560000000000,7,0,1,36,38,82
1334686620000000000,7,0,0,37,38,82
1334686680000000000,7,0,0,38,38,83
1334686740000000000,7,0,0,38,38,83
1334686800000000000,7,0,0,38,39,84
1334686860000000000,7,0,0,38,38,83
1334686920000000000,7,0,0,38,38,83
1334686980000000000,7,0,0,37,38,82
1334687040000000000,7,0,0,37,38,82
1334687100000000000,7,0,1,38,37,83
1334687160000000000,7,0,0,38,38,83
1334687220000000000,7,0,7,37,38,89
1334687280000000000,7,0,7,37,39,90
1334687340000000000,7,0,7,37,38,89
1334687400000000000,7,0,7,37,38,89
1334687460000000000,7,0,7,38,38,90
1334687520000000000,7,0,7,37,38,89
1334687580000000000,7,0,149,37,38,231
1334687640000000000,7,0,139,38,38,222
1334687700000000000,7,0,137,37,38,219
1334687760000000000,7,0,135,38,38,218
1334687820000000000,7,0,135,37,38,217
1334687880000000000,7,0,134,38,38,217
1334687940000000000,7,0,133,38,38,216
1334688000000000000,7,0,133,37,38,215
1334688060000000000,7,0,133,37,38,215
1334688120000000000,7,0,132,38,38,215
1334688180000000000,7,0,131,37,38,213
1334688240000000000,7,0,131,36,38,212
1334688300000000000,7,0,130,38,38,213
1334688360000000000,7,0,130,38,37,212
1334688420000000000,7,0,130,38,38,213
1334688480000000000,7,0,129,38,38,212
1334688540000000000,7,0,129,37,38,211
1334688600000000000,7,0,129,37,38,211
1334688660000000000,7,0,129,37,37,210
1334688720000000000,7,0,128,38,38,211
1334688780000000000,7,0,128,37,38,210
1334688840000000000,7,0,7,37,37,88
1334688900000000000,7,0,7,38,39,91
1334688960000000000,7,0,10,38,38,93
1334689020000000000,7,0,0,37,38,82
1334689080000000000,7,0,0,38,38,83
1334689140000000000,7,0,0,37,38,82
1334689200000000000,7,0,0,38,37,82
1334689260000000000,7,0,0,37,38,82
1334689320000000000,7,0,0,38,38,83
1334689380000000000,7,0,0,38,38,83
1334689440000000000,7,0,0,37,38,82
1334689500000000000,7,0,0,37,39,83
1334689560000000000,7,0,149,37,38,231
1334689620000000000,7,0,135,37,38,217
1334689680000000000,7,0,130,37,38,212
1334689740000000000,7,0,128,37,38,210
1334689800000000000,7,0,126,37,38,208
1334689860000000000,7,0,125,37,38,207
1334689920000000000,7,0,124,37,38,206
1334689980000000000,7,0,124,36,38,205
1334690040000000000,7,0,122,37,38,204
1334690100000000000,7,0,122,37,38,204
1334690160000000000,7,0,0,37,38,82
1334690220000000000,7,0,0,37,38,82
1334690280000000000,7,0,1,37,38,83
1334690340000000000,7,0,0,37,39,83
1334690400000000000,7,0,1,37,38,83
1334690460000000000,7,0,1,37,38,83
1334690520000000000,7,0,0,38,38,83
1334690580000000000,7,0,1,1452,38,1498
1334690640000000000,7,0,1,1630,37,1675
1334690700000000000,7,0,0,1721,39,1767
1334690760000000000,7,0,1,1757,37,1802
1334690820000000000,7,0,1,1767,38,1813
1334690880000000000,7,0,0,1790,38,1835
1334690940000000000,7,0,0,1763,38,1808
1334691000000000000,7,0,0,1768,38,1813
1334691060000000000,7,0,1,1786,38,1832
1334691120000000000,7,0,1,1785,38,1831
1334691180000000000,7,0,0,1793,38,1838
1334691240000000000,7,0,0,1802,38,1847
1334691300000000000,7,0,1,1815,38,1861
1334691360000000000,7,0,0,1806,38,1851
1334691420000000000,7,0,0,1807,38,1852
1334691480000000000,7,0,0,1822,38,1867
1334691540000000000,7,0,0,1814,38,1859
1334691600000000000,7,0,0,1811,38,1856
1334691660000000000,7,0,0,1,38,46
1334691720000000000,7,0,0,1,38,46
1334691780000000000,7,0,0,1,38,46
1334691840000000000,7,0,0,1,38,46
1334691900000000000,7,0,0,1,39,47
1334691960000000000,7,0,0,1,37,45
1334692020000000000,7,0,0,0,38,45
1334692080000000000,7,0,0,1,38,46
1334692140000000000,7,0,1,1,39,48
1334692200000000000,7,0,0,1,38,46
1334692260000000000,7,0,146,1,38,192
1334692320000000000,7,0,136,1,38,182
1334692380000000000,7,0,130,1,37,175
1334692440000000000,7,0,127,1,38,173
1334692500000000000,7,0,127,1,38,173
1334692560000000000,7,0,128,1,38,174
1334692620000000000,7,0,130,1,38,176
1334692680000000000,7,0,127,1,39,174
1334692740000000000,7,0,126,0,38,171
1334692800000000000,7,0,124,1,38,170
1334692860000000000,7,0,122,1,38,168
1334692920000000000,7,0,1,1,38,47
1334692980000000000,7,0,0,41,37,85
1334693040000000000,7,0,1,38,38,84
1334693100000000000,7,0,0,39,38,84
1334693160000000000,7,0,0,38,37,82
1334693220000000000,7,0,0,38,37,82
1334693280000000000,7,0,0,38,38,83
1334693340000000000,7,0,1,38,38,84
1334693400000000000,7,0,0,37,38,82
1334693460000000000,7,0,0,37,38,82
1334693520000000000,7,0,1,37,37,82
1334693580000000000,7,0,1,37,38,83
1334693640000000000,7,0,1,38,37,83
1334693700000000000,7,0,0,38,39,84
1334693760000000000,7,0,0,38,38,83
1334693820000000000,7,0,1,37,38,83
1334693880000000000,7,0,1,38,38,84
1334693940000000000,7,0,1,37,38,83
1334694000000000000,7,0,1,37,38,83
1334694060000000000,7,0,0,38,39,84
1334694120000000000,7,0,0,37,38,82
1334694180000000000,7,0,145,36,38,226
1334694240000000000,7,0,133,38,38,216
1334694300000000000,7,0,128,37,38,210
1334694360000000000,7,0,127,36,38,208
1334694420000000000,7,0,127,38,38,210
1334694480000000000,7,0,127,36,38,208
1334694540000000000,7,0,125,38,37,207
1334694600000000000,7,0,124,37,38,206
1334694660000000000,7,0,124,38,38,207
1334694720000000000,7,0,203,38,38,286
1334694780000000000,7,0,80,38,38,163
1334694840000000000,7,0,80,36,38,161
1334694900000000000,7,0,7,37,38,89
1334694960000000000,7,0,87,38,38,170
1334695020000000000,7,0,7,37,38,89
1334695080000000000,7,0,7,37,38,89
1334695140000000000,7,0,7,37,39,90
1334695200000000000,7,0,7,38,38,90
1334695260000000000,7,0,7,38,38,90
1334695320000000000,7,0,7,38,38,90
1334695380000000000,7,0,7,38,37,89
1334695440000000000,7,0,152,38,39,236
1334695500000000000,7,0,141,38,38,224
1334695560000000000,7,0,140,37,38,222
1334695620000000000,7,0,138,37,37,219
1334695680000000000,7,0,138,36,38,219
1334695740000000000,7,0,136,37,38,218
1334695800000000000,7,0,136,37,38,218
1334695860000000000,7,0,136,38,38,219
1334695920000000000,7,0,136,37,38,218
1334695980000000000,7,0,134,37,38,216
1334696040000000000,7,0,134,37,38,216
1334696100000000000,7,0,133,38,37,215
1334696160000000000,7,0,132,37,38,214
1334696220000000000,7,0,131,37,38,213
1334696280000000000,7,0,131,36,38,212
1334696340000000000,7,0,132,38,38,215
1334696400000000000,7,0,130,37,38,212
1334696460000000000,7,0,132,37,38,214
1334696520000000000,7,0,132,36,38,213
1334696580000000000,7,0,131,37,37,212
1334696640000000000,7,0,130,38,38,213
1334696700000000000,7,0,130,38,38,213
1334696760000000000,7,0,130,37,38,212
1334696820000000000,7,0,130,37,38,212
1334696880000000000,7,0,130,38,38,213
1334696940000000000,7,0,129,36,38,210
1334697000000000000,7,0,128,37,38,210
1334697060000000000,7,0,129,38,39,213
1334697120000000000,7,0,128,37,38,210
1334697180000000000,7,0,128,37,39,211
1334697240000000000,7,0,7,38,37,89
1334697300000000000,7,0,7,38,38,90
1334697360000000000,7,0,7,37,38,89
1334697420000000000,7,0,7,37,38,89
1334697480000000000,7,0,7,38,38,90
1334697540000000000,7,0,7,37,38,89
1334697600000000000,7,0,10,36,38,91
1334697660000000000,7,0,0,38,38,83
1334697720000000000,7,0,1,37,39,84
1334697780000000000,8,0,129,38,37,212
1334697840000000000,7,0,145,38,38,228
1334697900000000000,7,0,133,36,38,214
1334697960000000000,7,0,130,37,38,212
1334698020000000000,7,0,128,38,38,211
1334698080000000000,7,0,127,37,38,209
1334698140000000000,7,0,126,38,38,209
1334698200000000000,7,0,124,37,38,206
1334698260000000000,7,0,124,37,38,206
1334698320000000000,7,0,123,36,38,204
1334698380000000000,7,0,122,38,38,205
1334698440000000000,7,0,0,38,38,83
1334698500000000000,7,0,0,37,38,82
1334698560000000000,7,0,0,38,38,83
1334698620000000000,7,0,0,37,38,82
1334698680000000000,7,0,0,37,38,82
1334698740000000000,7,0,1,38,38,84
1334698800000000000,7,0,0,37,39,83
1334698860000000000,7,0,1,37,39,84
1334698920000000000,7,0,0,37,38,82
1334698980000000000,7,0,0,37,38,82
1334699040000000000,7,0,1,37,38,83
1334699100000000000,7,0,1,37,38,83
1334699160000000000,7,0,1,37,38,83
1334699220000000000,7,0,0,37,38,82
1334699280000000000,7,0,1,37,38,83
1334699340000000000,7,0,1,37,38,83
1334699400000000000,7,0,1,37,38,83
1334699460000000000,7,0,1,38,38,84
1334699520000000000,7,0,1,37,39,84
1334699580000000000,7,0,1,38,38,84
1334699640000000000,7,0,0,37,37,81
1334699700000000000,7,0,0,37,38,82
1334699760000000000,7,0,1,38,38,84
1334699820000000000,7,0,1,37,38,83
1334699880000000000,7,0,0,38,37,82
1334699940000000000,7,0,0,37,38,82
1334700000000000000,7,0,0,38,38,83
1334700060000000000,7,0,1,37,38,83
1334700120000000000,7,0,0,37,38,82
1334700180000000000,7,0,1,37,38,83
1334700240000000000,7,0,1,38,38,84
1334700300000000000,7,0,0,38,38,83
1334700360000000000,7,0,0,37,38,82
1334700420000000000,7,0,126,36,37,206
1334700480000000000,7,0,142,38,38,225
1334700540000000000,7,0,131,38,38,214
1334700600000000000,7,0,129,37,38,211
1334700660000000000,7,0,128,1577,38,1750
1334700720000000000,7,0,126,1693,38,1864
1334700780000000000,7,0,125,1739,38,1909
1334700840000000000,7,0,124,1757,38,1926
1334700900000000000,7,0,125,1778,37,1947
1334700960000000000,7,0,123,1746,37,1913
1334701020000000000,7,0,122,1765,38,1932
1334701080000000000,7,0,0,1769,38,1814
1334701140000000000,7,0,0,1774,38,1819
1334701200000000000,7,0,10,1789,39,1845
1334701260000000000,7,0,10,1787,38,1842
1334701320000000000,7,0,0,1782,37,1826
1334701380000000000,7,0,1,1793,38,1839
1334701440000000000,7,0,0,1792,38,1837
1334701500000000000,7,0,0,1795,38,1840
1334701560000000000,7,0,1,1799,38,1845
1334701620000000000,7,0,1,1794,38,1840
1334701680000000000,7,0,0,1799,38,1844
1334701740000000000,7,0,0,1,38,46
1334701800000000000,7,0,0,0,38,45
1334701860000000000,7,0,0,1,39,47
1334701920000000000,7,0,0,1,38,46
1334701980000000000,7,0,0,1,38,46
1334702040000000000,7,0,0,1,37,45
1334702100000000000,7,0,0,1,38,46
1334702160000000000,7,0,1,1,38,47
1334702220000000000,7,0,0,1,38,46
1334702280000000000,7,0,1,1,38,47
1334702340000000000,7,0,0,1,38,46
1334702400000000000,7,0,1,1,37,46
1334702460000000000,7,0,0,1,38,46
1334702520000000000,7,0,0,1,38,46
1334702580000000000,7,0,1,1,38,47
1334702640000000000,7,0,0,1,38,46
1334702700000000000,7,0,0,41,38,86
1334702760000000000,7,0,1,39,38,85
1334702820000000000,7,0,143,37,38,225
1334702880000000000,7,0,133,37,38,215
1334702940000000000,7,0,129,37,38,211
1334703000000000000,7,0,127,38,38,210
1334703060000000000,7,0,126,37,38,208
1334703120000000000,7,0,125,37,38,207
1334703180000000000,7,0,125,38,38,208
1334703240000000000,7,0,125,38,38,208
1334703300000000000,7,0,124,36,39,206
1334703360000000000,7,0,123,38,38,206
1334703420000000000,7,0,0,38,38,83
1334703480000000000,7,0,0,37,38,82
1334703540000000000,7,0,0,38,38,83
1334703600000000000,7,0,0,38,39,84
1334703660000000000,7,0,0,37,38,82
1334703720000000000,7,0,1,38,38,84
1334703780000000000,7,0,0,37,38,82
1334703840000000000,7,0,0,38,38,83
1334703900000000000,7,0,1,37,38,83
1334703960000000000,7,0,1,38,38,84
1334704020000000000,7,0,1,38,38,84
1334704080000000000,7,0,0,39,38,84
1334704140000000000,7,0,1,38,37,83
1334704200000000000,7,0,0,38,38,83
1334704260000000000,7,0,0,37,39,83
1334704320000000000,7,0,0,39,38,84
1334704380000000000,7,0,1,37,38,83
1334704440000000000,7,0,0,38,38,83
1334704500000000000,7,0,0,38,38,83
1334704560000000000,7,0,0,37,37,81
1334704620000000000,7,0,0,38,38,83
1334704680000000000,7,0,0,36,38,81
1334704740000000000,7,0,1,38,38,84
1334704800000000000,7,0,0,37,38,82
1334704860000000000,7,0,10,38,38,93
1334704920000000000,7,0,7,38,38,90
1334704980000000000,7,0,7,37,38,89
1334705040000000000,7,0,7,38,38,90
1334705100000000000,7,0,7,38,38,90
1334705160000000000,7,0,149,37,38,231
1334705220000000000,7,0,140,36,38,221
1334705280000000000,7,0,136,37,38,218
1334705340000000000,7,0,136,37,38,218
1334705400000000000,7,0,135,38,38,218
1334705460000000000,7,0,134,37,38,216
1334705520000000000,7,0,134,37,38,216
1334705580000000000,7,0,133,38,38,216
1334705640000000000,7,0,133,38,38,216
1334705700000000000,7,0,131,38,38,214
1334705760000000000,7,0,131,38,38,214
1334705820000000000,7,0,130,38,38,213
1334705880000000000,7,0,130,38,38,213
1334705940000000000,7,0,130,37,37,211
1334706000000000000,7,0,130,36,38,211
1334706060000000000,7,0,129,37,38,211
1334706120000000000,7,0,128,38,38,211
1334706180000000000,7,0,128,38,37,210
1334706240000000000,7,0,131,37,38,213
1334706300000000000,7,0,126,38,39,210
1334706360000000000,7,0,124,36,38,205
1334706420000000000,7,0,0,38,38,83
1334706480000000000,7,0,1,36,38,82
1334706540000000000,7,0,0,37,38,82
1334706600000000000,7,0,0,36,38,81
1334706660000000000,7,0,0,37,38,82
1334706720000000000,7,0,0,36,38,81
1334706780000000000,7,0,1,37,38,83
1334706840000000000,7,0,0,36,38,81
1334706900000000000,7,0,0,37,37,81
1334706960000000000,7,0,0,36,38,81
1334707020000000000,7,0,0,36,38,81
1334707080000000000,7,0,0,37,38,82
1334707140000000000,7,0,0,990,37,1034
1334707200000000000,7,0,0,1593,38,1638
1334707260000000000,7,0,0,1688,38,1733
1334707320000000000,122,0,29,1754,39,1944
1334707380000000000,334,0,0,1767,251,2352
1334707440000000000,332,0,0,1784,247,2363
1334707500000000000,333,0,0,1753,224,2310
1334707560000000000,332,0,0,1765,221,2318
1334707620000000000,334,0,0,1763,217,2314
1334707680000000000,334,0,0,1778,254,2366
1334707740000000000,330,0,0,1783,231,2344
1334707800000000000,329,0,0,1786,214,2329
1334707860000000000,328,0,0,1786,260,2374
1334707920000000000,329,0,10,1792,243,2374
1334707980000000000,329,0,7,1795,252,2383
1334708040000000000,332,0,6,1803,243,2384
1334708100000000000,331,0,154,1810,252,2547
1334708160000000000,331,0,140,1800,276,2547
1334708220000000000,332,0,138,1798,207,2475
1334708280000000000,333,0,137,1805,224,2499
1334708340000000000,334,0,137,1,182,654
1334708400000000000,333,0,136,0,215,684
1334708460000000000,334,0,136,0,228,698
1334708520000000000,334,0,135,1,192,662
1334708580000000000,333,0,134,0,226,693
1334708640000000000,333,0,133,1,267,734
1334708700000000000,334,0,133,1,224,692
1334708760000000000,334,0,132,1,248,715
1334708820000000000,333,0,131,1,258,723
1334708880000000000,332,0,131,0,253,716
1334708940000000000,330,0,130,1,260,721
1334709000000000000,331,0,129,0,247,707
1334709060000000000,330,0,129,0,273,732
1334709120000000000,329,0,129,0,387,845
1334709180000000000,330,0,129,1,321,781
1334709240000000000,331,0,128,39,252,750
1334709300000000000,331,0,128,38,247,744
1334709360000000000,328,0,127,36,238,729
1334709420000000000,329,0,127,36,259,751
1334709480000000000,328,0,128,36,265,757
1334709540000000000,328,0,127,36,266,757
1334709600000000000,329,0,128,36,262,755
1334709660000000000,331,0,127,36,265,759
1334709720000000000,332,0,7,36,229,604
1334709780000000000,330,0,0,37,302,669
1334709840000000000,329,0,0,36,232,597
1334709900000000000,331,0,0,37,244,612
1334709960000000000,329,0,0,37,302,668
1334710020000000000,329,0,0,37,256,622
1334710080000000000,329,0,0,36,257,622
1334710140000000000,329,0,0,38,260,627
1334710200000000000,329,0,0,36,265,630
1334710260000000000,330,0,0,36,273,639
1334710320000000000,331,0,0,36,270,637
1334710380000000000,331,0,0,35,254,620
1334710440000000000,330,0,0,36,223,589
1334710500000000000,333,0,0,38,209,580
1334710560000000000,330,0,0,37,209,576
1334710620000000000,333,0,0,36,224,593
1334710680000000000,331,0,0,36,213,580
1334710740000000000,331,0,0,37,224,592
1334710800000000000,330,0,0,36,378,744
1334710860000000000,335,0,0,37,249,621
1334710920000000000,332,0,0,37,48,417
1334710980000000000,7,0,0,37,48,92
1334711040000000000,7,0,139,37,49,232
1334711100000000000,7,0,140,38,49,234
1334711160000000000,7,0,129,37,48,221
1334711220000000000,7,0,127,36,48,218
1334711280000000000,7,0,127,36,48,218
1334711340000000000,7,0,125,36,48,216
1334711400000000000,7,0,124,37,49,217
1334711460000000000,7,0,123,36,48,214
1334711520000000000,7,0,122,37,48,214
1334711580000000000,7,0,122,38,49,216
1334711640000000000,7,0,121,36,48,212
1334711700000000000,7,0,0,36,48,91
1334711760000000000,7,0,0,38,48,93
1334711820000000000,7,0,0,37,49,93
1334711880000000000,7,0,0,37,48,92
1334711940000000000,7,0,0,36,49,92
1334712000000000000,7,0,0,36,48,91
1334712060000000000,7,0,0,36,49,92
1334712120000000000,7,0,0,36,48,91
1334712180000000000,7,0,0,36,49,92
1334712240000000000,7,0,0,38,48,93
1334712300000000000,7,0,0,37,49,93
1334712360000000000,7,0,80,37,48,172
1334712420000000000,7,0,0,36,48,91
1334712480000000000,7,0,0,36,48,91
1334712540000000000,7,0,0,36,48,91
1334712600000000000,7,0,0,37,49,93
1334712660000000000,7,0,0,37,47,91
1334712720000000000,7,0,0,37,48,92
1334712780000000000,7,0,0,36,48,91
1334712840000000000,7,0,0,37,48,92
1334712900000000000,7,0,0,37,48,92
1334712960000000000,7,0,80,36,49,172
1334713020000000000,7,0,0,36,48,91
1334713080000000000,7,0,10,36,39,92
1334713140000000000,7,0,7,37,38,89
1334713200000000000,7,0,7,37,38,89
1334713260000000000,7,0,7,37,37,88
1334713320000000000,7,0,7,38,39,91
1334713380000000000,7,0,150,37,38,232
1334713440000000000,7,0,141,37,38,223
1334713500000000000,7,0,138,36,38,219
1334713560000000000,7,0,136,36,38,217
1334713620000000000,7,0,135,36,38,216
1334713680000000000,7,0,134,35,37,213
1334713740000000000,7,0,135,36,37,215
1334713800000000000,7,0,132,36,37,212
1334713860000000000,7,0,132,37,38,214
1334713920000000000,7,0,132,36,38,213
1334713980000000000,7,0,131,37,38,213
1334714040000000000,7,0,210,36,38,291
1334714100000000000,7,0,132,36,38,213
1334714160000000000,7,0,210,36,38,291
1334714220000000000,7,0,131,36,38,212
1334714280000000000,7,0,131,37,38,213
1334714340000000000,7,0,131,35,37,210
1334714400000000000,7,0,132,37,38,214
1334714460000000000,7,0,131,36,38,212
1334714520000000000,7,0,130,36,37,210
1334714580000000000,7,0,130,36,38,211
1334714640000000000,7,0,129,37,38,211
1334714700000000000,7,0,129,37,38,211
1334714760000000000,7,0,129,36,38,210
1334714820000000000,7,0,128,37,38,210
1334714880000000000,7,0,128,36,38,209
1334714940000000000,7,0,128,37,37,209
1334715000000000000,7,0,127,37,38,209
1334715060000000000,7,0,127,36,37,207
1334715120000000000,7,0,7,36,38,88
1334715180000000000,7,0,7,35,38,87
1334715240000000000,7,0,7,36,37,87
1334715300000000000,7,0,7,36,38,88
1334715360000000000,7,0,7,36,37,87
1334715420000000000,7,0,7,37,38,89
1334715480000000000,7,0,10,37,38,92
1334715540000000000,7,0,0,36,38,81
1334715600000000000,7,0,0,36,37,80
1334715660000000000,7,0,0,36,37,80
1334715720000000000,7,0,147,37,37,228
1334715780000000000,7,0,142,35,38,222
1334715840000000000,7,0,131,36,38,212
1334715900000000000,7,0,128,36,38,209
1334715960000000000,7,0,127,38,38,210
1334716020000000000,7,0,126,36,38,207
1334716080000000000,7,0,126,38,38,209
1334716140000000000,7,0,123,38,38,206
1334716200000000000,7,0,123,37,38,205
1334716260000000000,7,0,122,36,38,203
1334716320000000000,7,0,121,36,37,201
1334716380000000000,7,0,0,37,38,82
1334716440000000000,7,0,1,35,38,81
1334716500000000000,7,0,0,36,38,81
1334716560000000000,7,0,0,37,37,81
1334716620000000000,7,0,0,36,37,80
1334716680000000000,7,0,0,36,38,81
1334716740000000000,7,0,1,37,38,83
1334716800000000000,7,0,1,35,37,80
1334716860000000000,7,0,0,36,37,80
1334716920000000000,7,0,0,35,38,80
1334716980000000000,7,0,0,35,38,80
1334717040000000000,7,0,1,37,37,82
1334717100000000000,7,0,1,36,38,82
1334717160000000000,7,0,0,36,37,80
1334717220000000000,7,0,1,37,37,82
1334717280000000000,7,0,1,36,38,82
1334717340000000000,7,0,0,36,37,80
1334717400000000000,7,0,1,36,38,82
1334717460000000000,7,0,0,36,38,81
1334717520000000000,7,0,1,36,37,81
1334717580000000000,7,0,0,36,38,81
1334717640000000000,7,0,0,37,37,81
1334717700000000000,7,0,1,36,39,83
1334717760000000000,7,0,0,38,37,82
1334717820000000000,7,0,1,36,37,81
1334717880000000000,7,0,0,36,37,80
1334717940000000000,7,0,1,37,38,83
1334718000000000000,7,0,0,36,38,81
1334718060000000000,7,0,0,3029,37,3073
1334718120000000000,7,0,1,1586,38,1632
1334718180000000000,7,0,0,1678,38,1723
1334718240000000000,7,0,1,1715,38,1761
1334718300000000000,7,0,0,1758,38,1803
1334718360000000000,7,0,0,1776,37,1820
1334718420000000000,7,0,143,1751,38,1939
1334718480000000000,7,0,132,1765,38,1942
1334718540000000000,7,0,127,1767,37,1938
1334718600000000000,7,0,128,1775,38,1948
1334718660000000000,7,0,125,1782,38,1952
1334718720000000000,7,0,124,1789,38,1958
1334718780000000000,7,0,123,1787,37,1954
1334718840000000000,7,0,122,1794,37,1960
1334718900000000000,7,0,122,1794,38,1961
1334718960000000000,7,0,122,1801,37,1967
1334719020000000000,7,0,0,1802,37,1846
1334719080000000000,7,0,10,1801,37,1855
1334719140000000000,7,0,10,1809,38,1864
1334719200000000000,7,0,0,1805,37,1849
1334719260000000000,7,0,1,1,39,48
1334719320000000000,7,0,1,1,38,47
1334719380000000000,7,0,0,1,38,46
1334719440000000000,7,0,0,1,38,46
1334719500000000000,7,0,1,0,38,46
1334719560000000000,7,0,0,0,38,45
1334719620000000000,7,0,0,1,38,46
1334719680000000000,7,0,0,1,38,46
1334719740000000000,7,0,0,1,38,46
1334719800000000000,7,0,0,1,38,46
1334719860000000000,7,0,0,1,37,45
1334719920000000000,7,0,0,1,38,46
1334719980000000000,7,0,0,1,38,46
1334720040000000000,7,0,0,1,38,46
1334720100000000000,7,0,0,1,37,45
1334720160000000000,7,0,0,1,37,45
1334720220000000000,7,0,0,38,38,83
1334720280000000000,7,0,0,38,38,83
1334720340000000000,7,0,0,37,38,82
1334720400000000000,7,0,0,37,38,82
1334720460000000000,7,0,0,38,38,83
1334720520000000000,7,0,0,38,38,83
1334720580000000000,7,0,0,38,38,83
1334720640000000000,7,0,0,36,38,81
1334720700000000000,7,0,0,36,39,82
1334720760000000000,7,0,142,37,38,224
1334720820000000000,7,0,139,38,39,223
1334720880000000000,7,0,129,36,38,210
1334720940000000000,7,0,128,36,38,209
1334721000000000000,7,0,127,36,38,208
1334721060000000000,7,0,125,38,38,208
1334721120000000000,7,0,125,36,38,206
1334721180000000000,7,0,123,37,38,205
1334721240000000000,7,0,122,37,38,204
1334721300000000000,7,0,122,37,38,204
1334721360000000000,7,0,0,36,38,81
1334721420000000000,7,0,0,36,38,81
1334721480000000000,7,0,0,37,38,82
1334721540000000000,7,0,0,38,37,82
1334721600000000000,7,0,0,38,38,83
1334721660000000000,7,0,0,35,38,80
1334721720000000000,7,0,0,37,37,81
1334721780000000000,7,0,0,37,38,82
1334721840000000000,7,0,0,36,38,81
1334721900000000000,7,0,0,36,38,81
1334721960000000000,7,0,10,37,37,91
1334722020000000000,7,0,7,38,38,90
1334722080000000000,7,0,7,36,38,88
1334722140000000000,7,0,7,37,38,89
1334722200000000000,7,0,7,35,38,87
1334722260000000000,7,0,7,36,38,88
1334722320000000000,7,0,7,38,38,90
1334722380000000000,7,0,7,36,37,87
1334722440000000000,7,0,7,38,38,90
1334722500000000000,6,0,848,37,38,929
1334722560000000000,7,0,148,36,38,229
1334722620000000000,7,0,138,37,38,220
1334722680000000000,7,0,136,36,38,217
1334722740000000000,7,0,135,37,37,216
1334722800000000000,7,0,134,36,38,215
1334722860000000000,7,0,133,36,38,214
1334722920000000000,7,0,132,36,37,212
1334722980000000000,7,0,131,36,37,211
1334723040000000000,7,0,131,37,38,213
1334723100000000000,7,0,130,36,38,211
1334723160000000000,7,0,129,37,38,211
1334723220000000000,7,0,130,36,38,211
1334723280000000000,7,0,129,36,38,210
1334723340000000000,7,0,128,38,38,211
1334723400000000000,7,0,130,37,38,212
1334723460000000000,7,0,128,36,38,209
1334723520000000000,7,0,128,36,38,209
1334723580000000000,7,0,128,37,38,210
1334723640000000000,7,0,127,38,38,210
1334723700000000000,7,0,125,1488,38,1658
1334723760000000000,7,0,0,1647,38,1692
1334723820000000000,7,0,0,1728,38,1773
1334723880000000000,7,0,0,1767,38,1812
1334723940000000000,7,0,0,1776,38,1821
1334724000000000000,7,0,0,1753,38,1798
1334724060000000000,7,0,0,1765,38,1810
1334724120000000000,7,0,0,1770,38,1815
1334724180000000000,380,0,0,1783,38,2201
1334724240000000000,386,0,0,1784,218,2388
1334724300000000000,374,0,0,1792,221,2387
1334724360000000000,372,0,0,1794,222,2388
1334724420000000000,379,0,0,1798,222,2399
1334724480000000000,371,0,0,1797,209,2377
1334724540000000000,372,0,0,1801,228,2401
1334724600000000000,376,0,0,1806,221,2403
1334724660000000000,375,0,0,1802,326,2503
1334724720000000000,380,0,0,1807,226,2413
1334724780000000000,376,0,0,1810,371,2557
1334724840000000000,382,0,0,1,244,627
1334724900000000000,378,0,0,1,213,592
1334724960000000000,378,0,0,1,223,602
1334725020000000000,378,0,0,1,217,596
1334725080000000000,377,0,0,1,219,597
1334725140000000000,375,0,0,1,210,586
1334725200000000000,376,0,0,0,209,585
1334725260000000000,375,0,0,1,272,648
1334725320000000000,376,0,0,1,255,632
1334725380000000000,371,0,0,1,218,590
1334725440000000000,371,0,0,1,218,590
1334725500000000000,371,0,0,1,252,624
1334725560000000000,371,0,123,1,280,775
1334725620000000000,372,0,140,1,217,730
1334725680000000000,371,0,129,1,235,736
1334725740000000000,375,0,127,43,244,789
1334725800000000000,376,0,126,38,230,770
1334725860000000000,377,0,125,38,208,748
1334725920000000000,376,0,126,38,393,933
1334725980000000000,378,0,123,38,233,772
1334726040000000000,377,0,122,38,392,929
1334726100000000000,377,0,121,37,381,916
1334726160000000000,379,0,0,37,186,602
1334726220000000000,377,0,0,38,230,645
1334726280000000000,385,0,0,36,234,655
1334726340000000000,377,0,0,36,385,798
1334726400000000000,378,0,0,36,237,651
1334726460000000000,381,0,0,37,248,666
1334726520000000000,375,0,0,35,244,654
1334726580000000000,377,0,0,38,238,653
1334726640000000000,376,0,0,36,258,670
1334726700000000000,377,0,0,38,225,640
1334726760000000000,375,0,0,36,228,639
1334726820000000000,375,0,0,36,310,721
1334726880000000000,375,0,0,37,259,671
1334726940000000000,375,0,0,37,382,794
1334727000000000000,376,0,0,37,226,639
1334727060000000000,376,0,0,37,236,649
1334727120000000000,373,0,0,36,230,639
1334727180000000000,375,0,0,38,232,645
1334727240000000000,374,0,7,36,237,654
1334727300000000000,373,0,0,38,234,645
1334727360000000000,374,0,0,36,219,629
1334727420000000000,377,0,0,1262,234,1873
1334727480000000000,373,0,0,1598,234,2205
1334727540000000000,374,0,0,1723,235,2332
1334727600000000000,375,0,0,1758,244,2377
1334727660000000000,375,0,0,1782,239,2396
1334727720000000000,375,0,0,1759,223,2357
1334727780000000000,376,0,0,1773,260,2409
1334727840000000000,374,0,0,1785,234,2393
1334727900000000000,377,0,0,1786,259,2422
1334727960000000000,375,0,143,1797,387,2702
1334728020000000000,377,0,139,1801,216,2533
1334728080000000000,377,0,129,1802,348,2656
1334728140000000000,377,0,127,1807,222,2533
1334728200000000000,376,0,127,1807,225,2535
1334728260000000000,377,0,125,1811,233,2546
1334728320000000000,381,0,124,1817,240,2562
1334728380000000000,378,0,123,1815,232,2548
1334728440000000000,378,0,123,1,230,732
1334728500000000000,378,0,122,1,236,737
1334728560000000000,380,0,0,1,249,630
1334728620000000000,380,0,0,1,223,604
1334728680000000000,382,0,0,0,248,630
1334728740000000000,382,0,0,1,242,625
1334728800000000000,379,0,0,0,317,696
1334728860000000000,379,0,0,0,255,634
1334728920000000000,379,0,0,0,248,627
1334728980000000000,382,0,0,1,312,695
1334729040000000000,394,0,0,1,241,636
1334729100000000000,391,0,0,1,404,796
1334729160000000000,390,0,0,1,232,623
1334729220000000000,388,0,0,1,230,619
1334729280000000000,390,0,0,1,234,625
1334729340000000000,390,0,0,0,233,623
1334729400000000000,396,0,0,39,237,672
1334729460000000000,388,0,0,41,238,667
1334729520000000000,390,0,0,38,239,667
1334729580000000000,390,0,0,38,230,658
1334729640000000000,389,0,0,37,233,659
1334729700000000000,387,0,0,38,238,663
1334729760000000000,387,0,0,37,234,658
1334729820000000000,371,0,0,38,244,653
1334729880000000000,365,0,0,37,236,638
1334729940000000000,402,0,0,37,294,733
1334730000000000000,362,0,0,38,314,714
1334730060000000000,339,0,0,37,232,608
1334730120000000000,337,0,0,38,233,608
1334730180000000000,337,0,0,38,240,615
1334730240000000000,336,0,0,37,249,622
1334730300000000000,331,0,0,37,252,620
1334730360000000000,328,0,0,36,272,636
1334730420000000000,329,0,0,36,378,743
1334730480000000000,329,0,0,36,270,635
1334730540000000000,330,0,0,37,236,603
1334730600000000000,329,0,0,36,227,592
1334730660000000000,330,0,0,37,265,632
1334730720000000000,329,0,143,36,300,808
1334730780000000000,332,0,132,37,388,889
1334730840000000000,333,0,130,37,261,761
1334730900000000000,333,0,131,36,241,741
1334730960000000000,333,0,127,36,393,889
1334731020000000000,333,0,126,36,226,721
1334731080000000000,332,0,124,36,292,784
1334731140000000000,334,0,123,36,221,714
1334731200000000000,334,0,124,38,228,724
1334731260000000000,333,0,122,37,229,721
1334731320000000000,331,0,0,37,222,590
1334731380000000000,332,0,0,1008,228,1568
1334731440000000000,332,0,0,1582,228,2142
1334731500000000000,332,0,0,1698,216,2246
1334731560000000000,333,0,0,1754,222,2309
1334731620000000000,334,0,0,1779,219,2332
1334731680000000000,334,0,0,1792,229,2355
1334731740000000000,334,0,0,1763,277,2374
1334731800000000000,334,0,0,1782,245,2361
1334731860000000000,334,0,0,1785,244,2363
1334731920000000000,7,0,0,1791,38,1836
1334731980000000000,7,0,0,1795,38,1840
1334732040000000000,7,0,7,1801,38,1853
1334732100000000000,7,0,7,1802,39,1855
1334732160000000000,7,0,7,1802,38,1854
1334732220000000000,7,0,7,1807,39,1860
1334732280000000000,7,0,7,1809,39,1862
1334732340000000000,7,0,7,1816,38,1868
1334732400000000000,7,0,7,1806,38,1858
1334732460000000000,7,0,7,1813,38,1865
1334732520000000000,7,0,156,1816,38,2017
1334732580000000000,7,0,143,1818,38,2006
1334732640000000000,7,0,138,1814,38,1997
1334732700000000000,7,0,137,1,38,183
1334732760000000000,7,0,134,1,38,180
1334732820000000000,7,0,135,1,39,182
1334732880000000000,7,0,133,1,38,179
1334732940000000000,7,0,133,1,38,179
1334733000000000000,7,0,132,1,38,178
1334733060000000000,7,0,132,1,38,178
1334733120000000000,7,0,132,1,37,177
1334733180000000000,7,0,130,1,38,176
1334733240000000000,7,0,129,1,38,175
1334733300000000000,7,0,131,1,38,177
1334733360000000000,7,0,131,1,38,177
1334733420000000000,7,0,129,1,38,175
1334733480000000000,7,0,130,1,38,176
1334733540000000000,7,0,128,1,37,173
1334733600000000000,7,0,127,38,38,210
1334733660000000000,7,0,127,37,38,209
1334733720000000000,7,0,127,38,38,210
1334733780000000000,7,0,130,37,38,212
1334733840000000000,7,0,0,36,38,81
1334733900000000000,7,0,0,36,38,81
1334733960000000000,7,0,1,38,38,84
1334734020000000000,7,0,0,38,38,83
1334734080000000000,7,0,0,38,37,82
1334734140000000000,7,0,0,38,38,83
1334734200000000000,7,0,0,37,39,83
1334734260000000000,7,0,0,36,38,81
1334734320000000000,7,0,0,37,39,83
1334734380000000000,7,0,0,38,38,83
1334734440000000000,7,0,1,37,38,83
1334734500000000000,7,0,0,38,38,83
1334734560000000000,7,0,0,37,38,82
1334734620000000000,7,0,0,38,38,83
1334734680000000000,7,0,0,38,38,83
1334734740000000000,7,0,0,36,38,81
1334734800000000000,7,0,0,38,38,83
1334734860000000000,7,0,0,37,39,83
1334734920000000000,7,0,0,36,38,81
1334734980000000000,7,0,0,38,38,83
1334735040000000000,7,0,0,38,38,83
1334735100000000000,7,0,0,36,37,80
1334735160000000000,7,0,0,36,38,81
1334735220000000000,7,0,148,36,38,229
1334735280000000000,7,0,134,1452,39,1632
1334735340000000000,7,0,131,1640,38,1816
1334735400000000000,7,0,127,1743,39,1916
1334735460000000000,7,0,126,1779,38,1950
1334735520000000000,7,0,127,1789,38,1961
1334735580000000000,7,0,124,1766,38,1935
1334735640000000000,7,0,123,1770,39,1939
1334735700000000000,7,0,123,1782,38,1950
1334735760000000000,7,0,122,1789,38,1956
1334735820000000000,7,0,0,1791,38,1836
1334735880000000000,7,0,0,1798,39,1844
1334735940000000000,7,0,0,1795,38,1840
1334736000000000000,7,0,0,1805,38,1850
1334736060000000000,7,0,0,1801,37,1845
1334736120000000000,7,0,0,1802,38,1847
1334736180000000000,7,0,0,1799,38,1844
1334736240000000000,7,0,0,1809,38,1854
1334736300000000000,7,0,0,1809,38,1854
1334736360000000000,7,0,0,1811,37,1855
1334736420000000000,7,0,0,1815,38,1860
1334736480000000000,7,0,0,1819,38,1864
1334736540000000000,7,0,0,1811,38,1856
1334736600000000000,7,0,0,1,38,46
1334736660000000000,7,0,0,1,38,46
1334736720000000000,7,0,0,1,38,46
1334736780000000000,7,0,0,1,38,46
1334736840000000000,7,0,1,1,38,47
1334736900000000000,7,0,1,1,38,47
1334736960000000000,7,0,1,0,38,46
1334737020000000000,7,0,0,1,38,46
1334737080000000000,7,0,1,1,38,47
1334737140000000000,7,0,0,1,38,46
1334737200000000000,7,0,1,1,38,47
1334737260000000000,7,0,0,1,38,46
1334737320000000000,7,0,0,1,38,46
1334737380000000000,7,0,10,1,38,56
1334737440000000000,7,0,7,1,39,54
1334737500000000000,7,0,0,39,38,84
1334737560000000000,7,0,0,38,38,83
1334737620000000000,7,0,0,38,38,83
1334737680000000000,7,0,1,39,38,85
1334737740000000000,7,0,150,38,38,233
1334737800000000000,7,0,139,38,38,222
1334737860000000000,7,0,130,38,38,213
1334737920000000000,7,0,129,38,38,212
1334737980000000000,7,0,127,38,37,209
1334738040000000000,7,0,127,37,38,209
1334738100000000000,7,0,125,38,39,209
1334738160000000000,7,0,124,37,39,207
1334738220000000000,7,0,122,38,38,205
1334738280000000000,7,0,122,38,38,205
1334738340000000000,7,0,0,38,38,83
1334738400000000000,7,0,0,38,38,83
1334738460000000000,7,0,1,36,38,82
1334738520000000000,7,0,0,37,38,82
1334738580000000000,7,0,1,37,37,82
1334738640000000000,7,0,1,38,38,84
1334738700000000000,7,0,0,38,38,83
1334738760000000000,7,0,0,38,38,83
1334738820000000000,7,0,0,38,39,84
1334738880000000000,7,0,1,38,38,84
1334738940000000000,7,0,1,38,38,84
1334739000000000000,7,0,0,1575,38,1620
1334739060000000000,7,0,0,1697,37,1741
1334739120000000000,7,0,0,1754,37,1798
1334739180000000000,7,0,0,1791,38,1836
1334739240000000000,7,0,0,1762,38,1807
1334739300000000000,7,0,0,1774,37,1818
1334739360000000000,7,0,0,1787,38,1832
1334739420000000000,7,0,0,1785,38,1830
1334739480000000000,7,0,0,1798,38,1843
1334739540000000000,7,0,0,1801,38,1846
1334739600000000000,7,0,0,1807,38,1852
1334739660000000000,7,0,0,1807,38,1852
1334739720000000000,7,0,0,1811,38,1856
1334739780000000000,7,0,0,1810,39,1856
1334739840000000000,7,0,0,1813,38,1858
1334739900000000000,7,0,0,1815,38,1860
1334739960000000000,7,0,0,1819,39,1865
1334740020000000000,7,0,1,1821,38,1867
1334740080000000000,7,0,0,1817,38,1862
1334740140000000000,7,0,0,1825,38,1870
1334740200000000000,7,0,1,1824,38,1870
1334740260000000000,7,0,0,1829,37,1873
1334740320000000000,7,0,0,1822,39,1868
1334740380000000000,7,0,0,1827,38,1872
1334740440000000000,7,0,0,1822,38,1867
1334740500000000000,7,0,144,1,38,190
1334740560000000000,7,0,140,1,38,186
1334740620000000000,7,0,131,1,38,177
1334740680000000000,7,0,130,1,37,175
1334740740000000000,7,0,127,1,38,173
1334740800000000000,7,0,126,1,38,172
1334740860000000000,7,0,126,1,38,172
1334740920000000000,7,0,125,1,38,171
1334740980000000000,7,0,124,1,38,170
1334741040000000000,7,0,124,0,38,169
1334741100000000000,7,0,0,1,38,46
1334741160000000000,7,0,0,1,38,46
1334741220000000000,7,0,0,1,38,46
1334741280000000000,7,0,0,1,38,46
1334741340000000000,7,0,0,1,38,46
1334741400000000000,7,0,0,42,38,87
1334741460000000000,7,0,0,39,37,83
1334741520000000000,7,0,0,38,38,83
1334741580000000000,7,0,0,39,38,84
1334741640000000000,7,0,0,37,38,82
1334741700000000000,7,0,0,38,38,83
1334741760000000000,7,0,0,38,38,83
1334741820000000000,7,0,0,38,38,83
1334741880000000000,7,0,0,38,38,83
1334741940000000000,7,0,0,37,38,82
1334742000000000000,7,0,0,37,39,83
1334742060000000000,7,0,1,37,38,83
1334742120000000000,7,0,0,39,38,84
1334742180000000000,7,0,0,38,38,83
1334742240000000000,7,0,0,37,38,82
1334742300000000000,7,0,0,37,39,83
1334742360000000000,7,0,0,38,38,83
1334742420000000000,7,0,0,39,38,84
1334742480000000000,7,0,10,38,38,93
1334742540000000000,7,0,7,38,38,90
1334742600000000000,7,0,7,37,38,89
1334742660000000000,7,0,7,37,38,89
1334742720000000000,7,0,7,37,38,89
1334742780000000000,7,0,153,38,37,235
1334742840000000000,7,0,139,38,37,221
1334742900000000000,7,0,137,38,38,220
1334742960000000000,7,0,136,38,38,219
1334743020000000000,7,0,134,38,37,216
1334743080000000000,7,0,134,1295,39,1475
1334743140000000000,7,0,133,1612,38,1790
1334743200000000000,7,0,132,1718,38,1895
1334743260000000000,7,0,132,1768,37,1944
1334743320000000000,7,0,131,1792,38,1968
1334743380000000000,7,0,130,1769,39,1945
1334743440000000000,7,0,130,1775,38,1950
1334743500000000000,7,0,131,1791,39,1968
1334743560000000000,7,0,129,1792,39,1967
1334743620000000000,7,0,131,1799,39,1976
1334743680000000000,7,0,128,1802,39,1976
1334743740000000000,7,0,128,1805,38,1978
1334743800000000000,7,0,129,1808,38,1982
1334743860000000000,7,0,128,1808,38,1981
1334743920000000000,7,0,129,1813,38,1987
1334743980000000000,7,0,7,1816,37,1867
1334744040000000000,7,0,7,1814,38,1866
1334744100000000000,7,0,7,1810,39,1863
1334744160000000000,7,0,0,1817,38,1862
1334744220000000000,7,0,0,1818,39,1864
1334744280000000000,7,0,0,1818,38,1863
1334744340000000000,7,0,0,1824,39,1870
1334744400000000000,7,0,0,1821,39,1867
1334744460000000000,7,0,0,1816,38,1861
1334744520000000000,7,0,0,1,38,46
1334744580000000000,7,0,0,1,38,46
1334744640000000000,7,0,1,0,38,46
1334744700000000000,7,0,0,1,38,46
1334744760000000000,7,0,0,1,38,46
1334744820000000000,7,0,0,1,37,45
1334744880000000000,7,0,1,1,38,47
1334744940000000000,7,0,145,1,38,191
1334745000000000000,7,0,131,1,38,177
1334745060000000000,7,0,128,1,38,174
1334745120000000000,7,0,127,1,39,174
1334745180000000000,7,0,126,0,38,171
1334745240000000000,7,0,124,0,38,169
1334745300000000000,7,0,125,1,39,172
1334745360000000000,7,0,123,1,38,169
1334745420000000000,7,0,122,0,38,167
1334745480000000000,7,0,0,17,38,62
1334745540000000000,7,0,0,39,38,84
1334745600000000000,7,0,0,37,38,82
1334745660000000000,7,0,0,38,39,84
1334745720000000000,7,0,0,39,38,84
1334745780000000000,7,0,0,38,38,83
1334745840000000000,7,0,0,38,38,83
1334745900000000000,7,0,0,38,38,83
1334745960000000000,7,0,0,37,38,82
1334746020000000000,7,0,0,38,38,83
1334746080000000000,7,0,0,38,38,83
1334746140000000000,7,0,0,37,38,82
1334746200000000000,7,0,0,38,39,84
1334746260000000000,7,0,1,38,38,84
1334746320000000000,7,0,0,38,38,83
1334746380000000000,7,0,1,37,38,83
1334746440000000000,7,0,0,38,37,82
1334746500000000000,7,0,0,38,37,82
1334746560000000000,7,0,0,37,38,82
1334746620000000000,7,0,0,38,38,83
1334746680000000000,7,0,0,37,38,82
1334746740000000000,7,0,0,38,38,83
1334746800000000000,7,0,0,37,38,82
1334746860000000000,7,0,0,38,38,83
1334746920000000000,7,0,0,37,38,82
1334746980000000000,7,0,0,38,39,84
1334747040000000000,7,0,0,38,38,83
1334747100000000000,7,0,0,1517,39,1563
1334747160000000000,7,0,0,1657,38,1702
1334747220000000000,7,0,0,1751,38,1796
1334747280000000000,7,0,0,1781,38,1826
1334747340000000000,7,0,0,1762,38,1807
1334747400000000000,7,0,0,1776,38,1821
1334747460000000000,7,0,0,1778,38,1823
1334747520000000000,7,0,0,1785,38,1830
1334747580000000000,7,0,0,1797,38,1842
1334747640000000000,7,0,147,1798,37,1989
1334747700000000000,7,0,137,1803,39,1986
1334747760000000000,7,0,130,1801,38,1976
1334747820000000000,7,0,129,1817,38,1991
1334747880000000000,7,0,127,1813,38,1985
1334747940000000000,7,0,125,1810,37,1979
1334748000000000000,7,0,125,1810,38,1980
1334748060000000000,7,0,123,1814,37,1981
1334748120000000000,7,0,122,1819,38,1986
1334748180000000000,7,0,122,1816,38,1983
1334748240000000000,7,0,122,1817,38,1984
1334748300000000000,7,0,0,1821,38,1866
1334748360000000000,7,0,1,1823,38,1869
1334748420000000000,7,0,0,1825,39,1871
1334748480000000000,7,0,1,1817,38,1863
1334748540000000000,7,0,0,1826,38,1871
1334748600000000000,7,0,1,1,38,47
1334748660000000000,7,0,0,1,38,46
1334748720000000000,7,0,0,1,38,46
1334748780000000000,7,0,0,1,38,46
1334748840000000000,7,0,0,1,38,46
1334748900000000000,7,0,0,1,38,46
1334748960000000000,7,0,0,1,38,46
1334749020000000000,7,0,0,1,38,46
1334749080000000000,7,0,1,1,39,48
1334749140000000000,7,0,0,1,38,46
1334749200000000000,7,0,0,1,38,46
1334749260000000000,7,0,0,1,38,46
1334749320000000000,7,0,0,1,38,46
1334749380000000000,7,0,1,1,38,47
1334749440000000000,7,0,1,1,37,46
1334749500000000000,7,0,0,1,39,47
1334749560000000000,7,0,1,42,38,88
1334749620000000000,7,0,0,39,38,84
1334749680000000000,7,0,1,41,38,87
1334749740000000000,7,0,0,38,38,83
1334749800000000000,7,0,0,38,38,83
1334749860000000000,7,0,0,39,38,84
1334749920000000000,7,0,0,38,38,83
1334749980000000000,7,0,0,38,38,83
1334750040000000000,7,0,0,37,38,82
1334750100000000000,7,0,0,37,38,82
1334750160000000000,7,0,0,38,38,83
1334750220000000000,7,0,0,38,39,84
1334750280000000000,7,0,0,38,38,83
1334750340000000000,7,0,0,38,38,83
1334750400000000000,7,0,0,38,38,83
1334750460000000000,7,0,141,38,37,223
1334750520000000000,7,0,131,38,38,214
1334750580000000000,7,0,128,38,37,210
1334750640000000000,7,0,126,38,37,208
1334750700000000000,7,0,127,38,38,210
1334750760000000000,7,0,125,38,38,208
1334750820000000000,7,0,124,37,38,206
1334750880000000000,7,0,123,38,38,206
1334750940000000000,7,0,122,38,38,205
1334751000000000000,7,0,122,37,38,204
1334751060000000000,7,0,1,38,39,85
1334751120000000000,7,0,0,37,38,82
1334751180000000000,7,0,0,37,38,82
1334751240000000000,7,0,0,37,38,82
1334751300000000000,7,0,0,37,38,82
1334751360000000000,7,0,10,38,38,93
1334751420000000000,7,0,0,1031,38,1076
1334751480000000000,7,0,0,1584,38,1629
1334751540000000000,7,0,0,1705,37,1749
1334751600000000000,7,0,0,1755,38,1800
1334751660000000000,7,0,0,1784,37,1828
1334751720000000000,7,0,1,1761,38,1807
1334751780000000000,7,0,0,1771,38,1816
1334751840000000000,7,0,0,1776,38,1821
1334751900000000000,7,0,0,1783,38,1828
1334751960000000000,7,0,0,1787,38,1832
1334752020000000000,7,0,1,1794,38,1840
1334752080000000000,7,0,0,1799,37,1843
1334752140000000000,7,0,0,1803,39,1849
1334752200000000000,7,0,0,1806,38,1851
1334752260000000000,7,0,0,1806,38,1851
1334752320000000000,7,0,0,1805,38,1850
1334752380000000000,7,0,0,1811,37,1855
1334752440000000000,7,0,0,1810,38,1855
1334752500000000000,7,0,0,1809,38,1854
1334752560000000000,7,0,0,1813,38,1858
1334752620000000000,7,0,0,1817,38,1862
1334752680000000000,7,0,0,1818,39,1864
1334752740000000000,7,0,0,1819,38,1864
1334752800000000000,7,0,0,1819,38,1864
1334752860000000000,7,0,0,1823,38,1868
1334752920000000000,7,0,148,1826,38,2019
1334752980000000000,7,0,140,1824,37,2008
1334753040000000000,7,0,133,1825,38,2003
1334753100000000000,7,0,133,1,38,179
1334753160000000000,7,0,132,0,37,176
1334753220000000000,7,0,132,1,38,178
1334753280000000000,7,0,132,1,37,177
1334753340000000000,7,0,132,0,38,177
1334753400000000000,7,0,131,1,37,176
1334753460000000000,7,0,130,1,38,176
1334753520000000000,7,0,130,1,38,176
1334753580000000000,7,0,130,1,37,175
1334753640000000000,7,0,131,1,38,177
1334753700000000000,7,0,129,1,38,175
1334753760000000000,7,0,128,1,38,174
1334753820000000000,7,0,128,1,38,174
1334753880000000000,7,0,128,1,37,173
1334753940000000000,7,0,128,1,38,174
1334754000000000000,7,0,7,1,38,53
1334754060000000000,7,0,7,1,38,53
1334754120000000000,7,0,7,39,38,91
1334754180000000000,7,0,7,38,39,91
1334754240000000000,7,0,7,37,38,89
1334754300000000000,7,0,7,37,37,88
1334754360000000000,7,0,7,38,38,90
1334754420000000000,7,0,7,36,38,88
1334754480000000000,7,0,7,37,38,89
1334754540000000000,7,0,7,36,39,89
1334754600000000000,7,0,155,37,38,237
1334754660000000000,7,0,143,37,38,225
1334754720000000000,7,0,134,38,38,217
1334754780000000000,7,0,130,37,38,212
1334754840000000000,7,0,129,37,38,211
1334754900000000000,7,0,127,38,38,210
1334754960000000000,7,0,126,37,37,207
1334755020000000000,7,0,125,37,37,206
1334755080000000000,7,0,124,37,38,206
1334755140000000000,7,0,122,36,38,203
1334755200000000000,7,0,122,36,38,203
1334755260000000000,7,0,0,37,38,82
1334755320000000000,7,0,0,36,37,80
1334755380000000000,7,0,0,37,38,82
1334755440000000000,7,0,0,38,38,83
1334755500000000000,7,0,1,37,38,83
1334755560000000000,7,0,0,37,38,82
1334755620000000000,7,0,0,37,38,82
1334755680000000000,7,0,0,36,39,82
1334755740000000000,7,0,0,37,38,82
1334755800000000000,7,0,0,37,37,81
1334755860000000000,7,0,0,37,38,82
1334755920000000000,7,0,0,36,38,81
1334755980000000000,7,0,0,36,38,81
1334756040000000000,7,0,0,1428,38,1473
1334756100000000000,7,0,0,1635,38,1680
1334756160000000000,7,0,0,1749,38,1794
1334756220000000000,7,0,0,1777,38,1822
1334756280000000000,7,0,1,1793,38,1839
1334756340000000000,7,0,0,1771,38,1816
1334756400000000000,7,0,0,1778,38,1823
1334756460000000000,7,0,0,1791,38,1836
1334756520000000000,7,0,0,1799,38,1844
1334756580000000000,7,0,0,1802,38,1847
1334756640000000000,7,0,0,1802,38,1847
1334756700000000000,7,0,0,1806,38,1851
1334756760000000000,7,0,0,1810,37,1854
1334756820000000000,7,0,0,1810,38,1855
1334756880000000000,7,0,0,1814,39,1860
1334756940000000000,7,0,0,1811,38,1856
1334757000000000000,7,0,0,1817,38,1862
1334757060000000000,7,0,0,1818,38,1863
1334757120000000000,7,0,0,1814,38,1859
1334757180000000000,7,0,0,1818,38,1863
1334757240000000000,7,0,0,1817,37,1861
1334757300000000000,7,0,143,1819,38,2007
1334757360000000000,7,0,138,1822,37,2004
1334757420000000000,7,0,130,1823,38,1998
1334757480000000000,7,0,127,1826,38,1998
1334757540000000000,7,0,126,1827,37,1997
1334757600000000000,7,0,125,1822,38,1992
1334757660000000000,7,0,123,1824,38,1992
1334757720000000000,7,0,122,1824,38,1991
1334757780000000000,7,0,122,1824,38,1991
1334757840000000000,7,0,121,1,37,166
1334757900000000000,7,0,0,1,37,45
1334757960000000000,7,0,0,1,37,45
1334758020000000000,7,0,0,1,38,46
1334758080000000000,7,0,0,1,38,46
1334758140000000000,7,0,0,1,39,47
1334758200000000000,7,0,7,1,38,53
1334758260000000000,7,0,0,1,38,46
1334758320000000000,7,0,0,1,38,46
1334758380000000000,7,0,0,1,38,46
1334758440000000000,7,0,0,1,38,46
1334758500000000000,7,0,0,1,38,46
1334758560000000000,7,0,0,1,37,45
1334758620000000000,7,0,0,0,37,44
1334758680000000000,7,0,0,1,38,46
1334758740000000000,7,0,0,41,38,86
1334758800000000000,7,0,0,38,37,82
1334758860000000000,7,0,0,37,38,82
1334758920000000000,7,0,1,36,38,82
1334758980000000000,7,0,1,37,37,82
1334759040000000000,7,0,1,37,39,84
1334759100000000000,7,0,0,38,37,82
1334759160000000000,7,0,0,36,37,80
1334759220000000000,7,0,0,37,38,82
1334759280000000000,7,0,1,37,38,83
1334759340000000000,7,0,0,37,38,82
1334759400000000000,7,0,0,36,37,80
1334759460000000000,7,0,0,37,38,82
1334759520000000000,7,0,1,37,38,83
1334759580000000000,7,0,0,37,37,81
1334759640000000000,7,0,0,37,38,82
1334759700000000000,7,0,0,37,37,81
1334759760000000000,7,0,130,36,38,211
1334759820000000000,7,0,142,37,38,224
1334759880000000000,7,0,130,37,38,212
1334759940000000000,7,0,127,1554,37,1725
1334760000000000000,7,0,127,1689,38,1861
1334760060000000000,7,0,125,1767,39,1938
1334760120000000000,7,0,125,1791,38,1961
1334760180000000000,7,0,123,1768,38,1936
1334760240000000000,7,0,122,1781,38,1948
1334760300000000000,7,0,123,1795,38,1963
1334760360000000000,7,0,1,1795,38,1841
1334760420000000000,7,0,0,1807,38,1852
1334760480000000000,7,0,0,1808,39,1854
1334760540000000000,7,0,0,1817,38,1862
1334760600000000000,7,0,0,1815,38,1860
1334760660000000000,7,0,0,1818,38,1863
1334760720000000000,7,0,1,1824,38,1870
1334760780000000000,7,0,1,1819,39,1866
1334760840000000000,7,0,0,1821,38,1866
1334760900000000000,7,0,1,1825,38,1871
1334760960000000000,7,0,0,1825,38,1870
1334761020000000000,7,0,0,1823,38,1868
1334761080000000000,7,0,0,1832,38,1877
1334761140000000000,7,0,0,1829,37,1873
1334761200000000000,7,0,0,1829,38,1874
1334761260000000000,7,0,0,1831,37,1875
1334761320000000000,7,0,0,1829,38,1874
1334761380000000000,7,0,0,1833,39,1879
1334761440000000000,7,0,0,1,38,46
1334761500000000000,7,0,0,1,38,46
1334761560000000000,7,0,0,1,38,46
1334761620000000000,7,0,0,1,37,45
1334761680000000000,7,0,0,1,38,46
1334761740000000000,7,0,0,1,39,47
1334761800000000000,7,0,0,1,38,46
1334761860000000000,7,0,10,1,38,56
1334761920000000000,7,0,1,1,38,47
1334761980000000000,7,0,0,0,38,45
1334762040000000000,7,0,0,1,38,46
1334762100000000000,7,0,0,1,38,46
1334762160000000000,7,0,1,1,38,47
1334762220000000000,7,0,0,1,38,46
1334762280000000000,7,0,0,1,38,46
1334762340000000000,7,0,147,1,38,193
1334762400000000000,7,0,134,1,38,180
1334762460000000000,7,0,128,38,38,211
1334762520000000000,7,0,127,37,38,209
1334762580000000000,7,0,126,37,38,208
1334762640000000000,7,0,126,38,38,209
1334762700000000000,7,0,123,38,38,206
1334762760000000000,7,0,123,36,37,203
1334762820000000000,7,0,122,36,38,203
1334762880000000000,7,0,122,37,37,203
1334762940000000000,7,0,0,37,38,82
1334763000000000000,7,0,0,38,38,83
1334763060000000000,7,0,0,38,38,83
1334763120000000000,7,0,0,37,38,82
1334763180000000000,7,0,1,38,38,84
1334763240000000000,7,0,1,38,37,83
1334763300000000000,7,0,0,36,38,81
1334763360000000000,7,0,10,38,38,93
1334763420000000000,7,0,7,37,37,88
1334763480000000000,7,0,7,36,37,87
1334763540000000000,7,0,7,1550,38,1602
1334763600000000000,7,0,7,1689,38,1741
1334763660000000000,7,0,7,1765,38,1817
1334763720000000000,7,0,7,1793,38,1845
1334763780000000000,7,0,7,1774,37,1825
1334763840000000000,7,0,7,1785,38,1837
1334763900000000000,7,0,7,1798,38,1850
1334763960000000000,7,0,7,1801,38,1853
1334764020000000000,7,0,147,1808,38,2000
1334764080000000000,7,0,139,1805,38,1989
1334764140000000000,7,0,137,1813,38,1995
1334764200000000000,7,0,135,1819,38,1999
1334764260000000000,7,0,135,1825,38,2005
1334764320000000000,7,0,133,1825,38,2003
1334764380000000000,7,0,132,1827,38,2004
1334764440000000000,7,0,132,1829,38,2006
1334764500000000000,7,0,131,1831,37,2006
1334764560000000000,7,0,131,1835,37,2010
1334764620000000000,7,0,130,1837,38,2012
1334764680000000000,7,0,130,1835,38,2010
1334764740000000000,7,0,129,1835,38,2009
1334764800000000000,7,0,129,1835,38,2009
1334764860000000000,7,0,129,1840,39,2015
1334764920000000000,7,0,128,1,38,174
1334764980000000000,7,0,130,1,38,176
1334765040000000000,7,0,128,1,38,174
1334765100000000000,7,0,126,1,38,172
1334765160000000000,7,0,124,1,38,170
1334765220000000000,7,0,123,1,38,169
1334765280000000000,7,0,122,1,38,168
1334765340000000000,7,0,121,1,38,167
1334765400000000000,7,0,120,1,38,166
1334765460000000000,7,0,0,1,39,47
1334765520000000000,7,0,0,1,38,46
1334765580000000000,7,0,0,1,38,46
1334765640000000000,7,0,0,1,38,46
1334765700000000000,7,0,455,1,38,501
1334765760000000000,7,0,450,0,38,495
1334765820000000000,7,0,438,39,37,521
1334765880000000000,7,0,433,37,38,515
1334765940000000000,7,0,431,38,37,513
1334766000000000000,7,0,434,37,37,515
1334766060000000000,7,0,435,36,38,516
1334766120000000000,7,0,433,36,38,514
1334766180000000000,7,0,434,37,37,515
1334766240000000000,7,0,437,37,37,518
1334766300000000000,7,0,445,37,38,527
1334766360000000000,7,0,446,37,38,528
1334766420000000000,7,0,444,36,38,525
1334766480000000000,7,0,444,37,38,526
1334766540000000000,7,0,449,36,38,530
1334766600000000000,7,0,1,37,38,83
1334766660000000000,7,0,1,37,38,83
1334766720000000000,7,0,1,37,38,83
1334766780000000000,7,0,1,38,38,84
1334766840000000000,7,0,1,37,39,84
1334766900000000000,7,0,152,37,38,234
1334766960000000000,7,0,154,37,37,235
1334767020000000000,7,0,155,37,38,237
1334767080000000000,7,0,154,38,37,236
1334767140000000000,7,0,146,37,38,228
1334767200000000000,7,0,143,38,38,226
1334767260000000000,7,0,141,38,38,224
1334767320000000000,7,0,139,37,38,221
1334767380000000000,7,0,137,37,38,219
1334767440000000000,7,0,216,38,38,299
1334767500000000000,7,0,134,37,38,216
1334767560000000000,7,0,133,37,38,215
1334767620000000000,7,0,132,38,38,215
1334767680000000000,7,0,132,38,38,215
1334767740000000000,7,0,130,1560,38,1735
1334767800000000000,7,0,130,1683,38,1858
1334767860000000000,7,0,129,1758,38,1932
1334767920000000000,7,0,128,1790,38,1963
1334767980000000000,7,0,127,1809,37,1980
1334768040000000000,7,0,127,1783,38,1955
1334768100000000000,7,0,125,1798,38,1968
1334768160000000000,7,0,125,1800,37,1969
1334768220000000000,7,0,124,1800,38,1969
1334768280000000000,7,0,123,1813,38,1981
1334768340000000000,7,0,10,1815,38,1870
1334768400000000000,7,0,7,1819,38,1871
1334768460000000000,7,0,7,1822,37,1873
1334768520000000000,7,0,7,1822,38,1874
1334768580000000000,7,0,7,1827,38,1879
1334768640000000000,7,0,7,1832,38,1884
1334768700000000000,7,0,7,1834,38,1886
1334768760000000000,7,0,7,1838,38,1890
1334768820000000000,7,0,7,1832,38,1884
1334768880000000000,7,0,149,1,37,194
1334768940000000000,7,0,144,1,37,189
1334769000000000000,7,0,136,0,38,181
1334769060000000000,7,0,180,1,38,226
1334769120000000000,7,0,137,1,37,182
1334769180000000000,7,0,137,1,38,183
1334769240000000000,7,0,137,1,37,182
1334769300000000000,7,0,136,1,37,181
1334769360000000000,7,0,135,1,38,181
1334769420000000000,7,0,134,1,38,180
1334769480000000000,7,0,133,1,38,179
1334769540000000000,7,0,132,1,38,178
1334769600000000000,7,0,132,1,38,178
1334769660000000000,7,0,132,1,38,178
1334769720000000000,7,0,132,1,38,178
1334769780000000000,7,0,132,0,38,177
1334769840000000000,7,0,130,1,38,176
1334769900000000000,7,0,131,1,38,177
1334769960000000000,7,0,131,41,38,217
1334770020000000000,7,0,130,38,38,213
1334770080000000000,7,0,130,37,39,213
1334770140000000000,7,0,131,37,38,213
1334770200000000000,7,0,129,38,37,211
1334770260000000000,7,0,129,38,37,211
1334770320000000000,7,0,128,37,37,209
1334770380000000000,7,0,126,36,37,206
1334770440000000000,7,0,124,37,38,206
1334770500000000000,7,0,0,37,38,82
1334770560000000000,7,0,1,37,38,83
1334770620000000000,7,0,0,37,38,82
1334770680000000000,7,0,0,38,38,83
1334770740000000000,7,0,0,37,38,82
1334770800000000000,7,0,0,38,37,82
1334770860000000000,7,0,0,36,38,81
1334770920000000000,7,0,0,38,38,83
1334770980000000000,7,0,0,36,38,81
1334771040000000000,7,0,1,36,38,82
1334771100000000000,7,0,0,37,38,82
1334771160000000000,7,0,0,37,39,83
1334771220000000000,7,0,0,37,38,82
1334771280000000000,7,0,0,37,38,82
1334771340000000000,7,0,0,37,38,82
1334771400000000000,7,0,0,37,38,82
1334771460000000000,7,0,0,37,38,82
1334771520000000000,7,0,1,38,38,84
1334771580000000000,7,0,0,37,38,82
1334771640000000000,7,0,0,37,38,82
1334771700000000000,7,0,0,38,37,82
1334771760000000000,7,0,0,37,37,81
1334771820000000000,7,0,0,36,38,81
1334771880000000000,7,0,0,37,38,82
1334771940000000000,7,0,145,37,38,227
1334772000000000000,7,0,131,37,38,213
1334772060000000000,7,0,127,37,38,209
1334772120000000000,7,0,126,38,38,209
1334772180000000000,7,0,125,36,38,206
1334772240000000000,7,0,126,38,38,209
1334772300000000000,7,0,125,37,39,208
1334772360000000000,7,0,123,36,38,204
1334772420000000000,7,0,122,36,38,203
1334772480000000000,7,0,122,36,38,203
1334772540000000000,7,0,0,37,38,82
1334772600000000000,7,0,0,38,38,83
1334772660000000000,7,0,0,37,38,82
1334772720000000000,7,0,0,37,37,81
1334772780000000000,7,0,0,37,38,82
1334772840000000000,7,0,0,37,38,82
1334772900000000000,7,0,0,36,38,81
1334772960000000000,7,0,0,36,38,81
1334773020000000000,7,0,0,36,38,81
1334773080000000000,7,0,0,37,38,82
1334773140000000000,7,0,0,37,38,82
1334773200000000000,7,0,0,35,39,81
1334773260000000000,7,0,80,36,38,161
1334773320000000000,7,0,0,36,38,81
1334773380000000000,7,0,0,37,38,82
1334773440000000000,7,0,0,38,38,83
1334773500000000000,7,0,0,37,39,83
1334773560000000000,7,0,0,38,37,82
1334773620000000000,7,0,0,37,38,82
1334773680000000000,7,0,0,37,38,82
1334773740000000000,7,0,0,36,38,81
1334773800000000000,7,0,7,36,38,88
1334773860000000000,7,0,7,36,38,88
1334773920000000000,7,0,7,36,37,87
1334773980000000000,7,0,7,37,37,88
1334774040000000000,7,0,146,36,38,227
1334774100000000000,7,0,142,37,38,224
1334774160000000000,7,0,138,37,38,220
1334774220000000000,7,0,136,36,38,217
1334774280000000000,7,0,135,38,38,218
1334774340000000000,7,0,133,37,38,215
1334774400000000000,7,0,133,36,38,214
1334774460000000000,7,0,132,36,38,213
1334774520000000000,7,0,133,37,38,215
1334774580000000000,7,0,132,37,38,214
1334774640000000000,7,0,131,38,38,214
1334774700000000000,7,0,131,37,38,213
1334774760000000000,7,0,131,37,38,213
1334774820000000000,7,0,132,36,39,214
1334774880000000000,7,0,133,37,38,215
1334774940000000000,7,0,133,38,38,216
1334775000000000000,7,0,132,37,38,214
1334775060000000000,7,0,132,37,38,214
1334775120000000000,7,0,130,38,37,212
1334775180000000000,7,0,130,36,38,211
1334775240000000000,7,0,131,37,38,213
1334775300000000000,7,0,129,37,38,211
1334775360000000000,7,0,129,38,38,212
1334775420000000000,7,0,130,37,39,213
1334775480000000000,7,0,129,37,38,211
1334775540000000000,7,0,130,38,39,214
1334775600000000000,7,0,128,37,38,210
1334775660000000000,7,0,127,36,39,209
1334775720000000000,7,0,128,37,39,211
1334775780000000000,7,0,128,37,38,210
1334775840000000000,7,0,7,37,38,89
1334775900000000000,7,0,10,38,38,93
1334775960000000000,7,0,1,37,38,83
1334776020000000000,7,0,1,37,38,83
1334776080000000000,7,0,0,37,38,82
1334776140000000000,7,0,1,35,38,81
1334776200000000000,7,0,1,35,38,81
1334776260000000000,7,0,1,38,38,84
1334776320000000000,7,0,0,37,38,82
1334776380000000000,7,0,0,1538,38,1583
1334776440000000000,7,0,0,1651,38,1696
1334776500000000000,7,0,0,1744,37,1788
1334776560000000000,7,0,0,1782,38,1827
1334776620000000000,7,0,148,1798,38,1991
1334776680000000000,7,0,133,1763,38,1941
1334776740000000000,7,0,127,1775,38,1947
1334776800000000000,7,0,126,1789,38,1960
1334776860000000000,7,0,125,1799,38,1969
1334776920000000000,7,0,124,1816,38,1985
1334776980000000000,7,0,122,1818,37,1984
1334777040000000000,7,0,122,1807,38,1974
1334777100000000000,7,0,122,1810,38,1977
1334777160000000000,7,0,120,1824,37,1988
1334777220000000000,7,0,0,1824,38,1869
1334777280000000000,7,0,0,1837,38,1882
1334777340000000000,7,0,1,1837,37,1882
1334777400000000000,7,0,0,1822,37,1866
1334777460000000000,7,0,0,0,38,45
1334777520000000000,7,0,0,1,38,46
1334777580000000000,7,0,0,1,37,45
1334777640000000000,7,0,1,1,38,47
1334777700000000000,7,0,1,1,38,47
1334777760000000000,7,0,0,1,38,46
1334777820000000000,7,0,1,1,38,47
1334777880000000000,7,0,0,0,38,45
1334777940000000000,7,0,0,1,38,46
1334778000000000000,7,0,1,1,38,47
1334778060000000000,7,0,1,1,37,46
1334778120000000000,7,0,1,1,38,47
1334778180000000000,7,0,1,1,38,47
1334778240000000000,7,0,0,1,38,46
1334778300000000000,7,0,0,1,38,46
1334778360000000000,7,0,1,1,38,47
1334778420000000000,7,0,1,1,38,47
1334778480000000000,7,0,0,0,37,44
1334778540000000000,7,0,0,39,38,84
1334778600000000000,7,0,0,37,38,82
1334778660000000000,7,0,1,36,38,82
1334778720000000000,7,0,0,37,38,82
1334778780000000000,7,0,0,37,37,81
1334778840000000000,387,0,0,38,37,462
1334778900000000000,376,0,0,38,37,451
1334778960000000000,378,0,0,37,38,453
1334779020000000000,377,0,0,37,38,452
1334779080000000000,384,0,0,38,38,460
1334779140000000000,377,0,0,38,38,453
1334779200000000000,379,0,0,36,38,453
1334779260000000000,378,0,142,37,38,595
1334779320000000000,376,0,129,36,38,579
1334779380000000000,377,0,127,37,38,579
1334779440000000000,377,0,125,37,38,577
1334779500000000000,377,0,130,36,39,582
1334779560000000000,379,0,127,37,38,581
1334779620000000000,378,0,124,36,38,576
1334779680000000000,378,0,123,36,38,575
1334779740000000000,378,0,122,36,38,574
1334779800000000000,378,0,122,37,37,574
1334779860000000000,379,0,0,37,38,454
1334779920000000000,378,0,0,37,38,453
1334779980000000000,380,0,0,37,39,456
1334780040000000000,379,0,0,36,38,453
1334780100000000000,381,0,0,38,38,457
1334780160000000000,378,0,0,36,37,451
1334780220000000000,379,0,0,37,38,454
1334780280000000000,379,0,0,36,38,453
1334780340000000000,381,0,0,37,38,456
1334780400000000000,386,0,0,37,38,461
1334780460000000000,379,0,0,37,38,454
1334780520000000000,381,0,0,38,38,457
1334780580000000000,380,0,0,37,37,454
1334780640000000000,380,0,0,37,38,455
1334780700000000000,377,0,0,36,37,450
1334780760000000000,385,0,0,36,39,460
1334780820000000000,379,0,0,38,38,455
1334780880000000000,378,0,0,38,38,454
1334780940000000000,388,0,81,37,38,544
1334781000000000000,377,0,0,37,38,452
1334781060000000000,378,0,0,37,38,453
1334781120000000000,376,0,0,36,38,450
1334781180000000000,378,0,0,38,38,454
1334781240000000000,380,0,0,37,38,455
1334781300000000000,381,0,10,37,38,466
1334781360000000000,381,0,7,37,38,463
1334781420000000000,381,0,7,38,38,464
1334781480000000000,381,0,7,37,38,463
1334781540000000000,381,0,156,36,38,611
1334781600000000000,382,0,142,36,38,598
1334781660000000000,381,0,137,37,38,593
1334781720000000000,387,0,136,37,38,598
1334781780000000000,384,0,135,36,38,593
1334781840000000000,380,0,134,37,38,589
1334781900000000000,382,0,135,37,38,592
1334781960000000000,379,0,132,37,38,586
1334782020000000000,380,0,131,37,39,587
1334782080000000000,381,0,132,37,38,588
1334782140000000000,382,0,130,38,38,588
1334782200000000000,378,0,130,37,37,582
1334782260000000000,380,0,130,36,37,583
1334782320000000000,380,0,129,38,38,585
1334782380000000000,380,0,130,37,38,585
1334782440000000000,379,0,129,36,38,582
1334782500000000000,379,0,130,36,38,583
1334782560000000000,379,0,128,37,38,582
1334782620000000000,381,0,128,37,38,584
1334782680000000000,382,0,128,36,38,584
1334782740000000000,381,0,128,37,38,584
1334782800000000000,380,0,128,37,38,583
1334782860000000000,381,0,7,36,38,462
1334782920000000000,380,0,7,38,38,463
1334782980000000000,381,0,7,38,37,463
1334783040000000000,380,0,7,36,39,462
1334783100000000000,379,0,7,38,37,461
1334783160000000000,379,0,0,37,38,454
1334783220000000000,381,0,0,37,39,457
1334783280000000000,378,0,0,37,38,453
1334783340000000000,378,0,0,37,38,453
1334783400000000000,377,0,0,37,38,452
1334783460000000000,376,0,145,36,38,595
1334783520000000000,376,0,131,36,37,580
1334783580000000000,379,0,128,37,38,582
1334783640000000000,378,0,127,37,38,580
1334783700000000000,377,0,126,36,37,576
1334783760000000000,377,0,124,37,37,575
1334783820000000000,377,0,123,36,37,573
1334783880000000000,377,0,122,1458,38,1995
1334783940000000000,377,0,121,1638,38,2174
1334784000000000000,376,0,121,1739,38,2274
1334784060000000000,385,0,0,1778,38,2201
1334784120000000000,384,0,0,1777,38,2199
1334784180000000000,377,0,0,1777,38,2192
1334784240000000000,377,0,0,1783,38,2198
1334784300000000000,385,0,0,1794,38,2217
1334784360000000000,377,0,0,1794,38,2209
1334784420000000000,376,0,0,1801,38,2215
1334784480000000000,375,0,0,1807,37,2219
1334784540000000000,375,0,0,1814,38,2227
1334784600000000000,377,0,0,1824,38,2239
1334784660000000000,381,0,0,1815,38,2234
1334784720000000000,375,0,0,1823,38,2236
1334784780000000000,375,0,0,1823,38,2236
1334784840000000000,374,0,0,1824,38,2236
1334784900000000000,374,0,0,1831,38,2243
1334784960000000000,376,0,0,1,38,415
1334785020000000000,377,0,0,1,38,416
1334785080000000000,377,0,0,1,38,416
1334785140000000000,379,0,0,0,38,417
1334785200000000000,378,0,0,1,38,417
1334785260000000000,377,0,0,1,38,416
1334785320000000000,375,0,0,1,38,414
1334785380000000000,377,0,0,1,38,416
1334785440000000000,378,0,0,38,38,454
1334785500000000000,377,0,0,38,37,452
1334785560000000000,377,0,0,38,39,454
1334785620000000000,375,0,0,36,38,449
1334785680000000000,376,0,0,37,38,451
1334785740000000000,375,0,0,38,38,451
1334785800000000000,378,0,0,36,37,451
1334785860000000000,378,0,0,37,38,453
1334785920000000000,379,0,0,37,38,454
1334785980000000000,378,0,0,37,38,453
1334786040000000000,378,0,143,38,38,597
1334786100000000000,377,0,138,37,38,590
1334786160000000000,378,0,128,37,38,581
1334786220000000000,378,0,126,37,38,579
1334786280000000000,380,0,126,37,38,581
1334786340000000000,377,0,124,38,38,577
1334786400000000000,380,0,124,38,37,579
1334786460000000000,382,0,124,37,39,582
1334786520000000000,381,0,122,38,38,579
1334786580000000000,381,0,122,37,37,577
1334786640000000000,381,0,0,38,38,457
1334786700000000000,388,0,7,39,38,472
1334786760000000000,382,0,0,37,38,457
1334786820000000000,381,0,0,38,38,457
1334786880000000000,380,0,0,37,38,455
1334786940000000000,381,0,0,38,38,457
1334787000000000000,380,0,0,36,38,454
1334787060000000000,386,0,0,37,37,460
1334787120000000000,381,0,0,37,38,456
1334787180000000000,389,0,0,38,38,465
1334787240000000000,377,0,0,38,38,453
1334787300000000000,382,0,0,36,37,455
1334787360000000000,382,0,0,38,38,458
1334787420000000000,379,0,0,37,38,454
1334787480000000000,379,0,0,37,38,454
1334787540000000000,377,0,0,36,38,451
1334787600000000000,377,0,0,37,38,452
1334787660000000000,379,0,0,38,38,455
1334787720000000000,387,0,0,38,38,463
1334787780000000000,388,0,0,37,38,463
1334787840000000000,384,0,0,37,38,459
1334787900000000000,384,0,0,37,39,460
1334787960000000000,364,0,0,37,38,439
1334788020000000000,361,0,0,37,38,436
1334788080000000000,363,0,0,1309,38,1710
1334788140000000000,387,0,0,1616,37,2040
1334788200000000000,380,0,127,1746,39,2292
1334788260000000000,379,0,142,1765,38,2324
1334788320000000000,378,0,128,1751,38,2295
1334788380000000000,377,0,127,1769,38,2311
1334788440000000000,379,0,125,1776,38,2318
1334788500000000000,380,0,124,1789,38,2331
1334788560000000000,381,0,125,1797,38,2341
1334788620000000000,379,0,123,1801,38,2341
1334788680000000000,378,0,122,1806,38,2344
1334788740000000000,387,0,122,1811,39,2359
1334788800000000000,377,0,0,1821,38,2236
1334788860000000000,378,0,0,1823,38,2239
1334788920000000000,378,0,0,1829,38,2245
1334788980000000000,380,0,0,1831,38,2249
1334789040000000000,377,0,0,1831,38,2246
1334789100000000000,380,0,0,1837,38,2255
1334789160000000000,381,0,0,1841,38,2260
1334789220000000000,378,0,0,1845,37,2260
1334789280000000000,373,0,0,1,38,412
1334789340000000000,375,0,0,1,37,413
1334789400000000000,375,0,0,1,37,413
1334789460000000000,376,0,0,1,38,415
1334789520000000000,378,0,0,2,37,417
1334789580000000000,377,0,0,1,38,416
1334789640000000000,29,0,0,1,38,68
1334789700000000000,27,0,1,1,38,67
1334789760000000000,25,0,0,1,38,64
1334789820000000000,26,0,1,1,38,66
1334789880000000000,25,0,1,1,38,65
1334789940000000000,25,0,0,1,38,64
1334790000000000000,33,0,1,1,38,73
1334790060000000000,33,0,0,1,38,72
1334790120000000000,33,0,0,1,38,72
1334790180000000000,33,0,0,1,37,71
1334790240000000000,33,0,0,1,38,72
1334790300000000000,33,0,10,1,37,81
1334790360000000000,33,0,7,38,38,116
1334790420000000000,33,0,7,38,38,116
1334790480000000000,33,0,7,37,37,114
1334790540000000000,40,0,154,36,37,267
1334790600000000000,39,0,139,37,37,252
1334790660000000000,40,0,135,37,38,250
1334790720000000000,37,0,135,37,38,247
1334790780000000000,35,0,134,36,38,243
1334790840000000000,34,0,134,37,38,243
1334790900000000000,33,0,134,37,38,242
1334790960000000000,33,0,132,36,39,240
1334791020000000000,33,0,132,38,38,241
1334791080000000000,33,0,132,37,38,240
1334791140000000000,33,0,131,36,38,238
1334791200000000000,33,0,132,38,38,241
1334791260000000000,33,0,132,36,38,239
1334791320000000000,26,0,133,37,38,234
1334791380000000000,26,0,131,37,38,232
1334791440000000000,26,0,131,36,37,230
1334791500000000000,26,0,130,36,39,231
1334791560000000000,26,0,130,37,38,231
1334791620000000000,26,0,129,37,37,229
1334791680000000000,26,0,129,38,38,231
1334791740000000000,25,0,130,37,38,230
1334791800000000000,26,0,129,37,38,230
1334791860000000000,25,0,127,38,38,228
1334791920000000000,25,0,53,37,37,152
1334791980000000000,25,0,7,38,37,107
1334792040000000000,25,0,7,37,37,106
1334792100000000000,25,0,7,36,38,106
1334792160000000000,26,0,7,37,37,107
1334792220000000000,25,0,7,37,37,106
1334792280000000000,25,0,7,36,38,106
1334792340000000000,26,0,7,36,38,107
1334792400000000000,25,0,7,38,38,108
1334792460000000000,26,0,150,37,37,250
1334792520000000000,26,0,134,37,38,235
1334792580000000000,26,0,131,37,38,232
1334792640000000000,27,0,129,35,38,229
1334792700000000000,26,0,128,37,38,229
1334792760000000000,25,0,127,36,37,225
1334792820000000000,25,0,126,37,38,226
1334792880000000000,25,0,124,37,37,223
1334792940000000000,26,0,123,36,37,222
1334793000000000000,25,0,122,36,38,221
1334793060000000000,25,0,122,37,38,222
1334793120000000000,25,0,0,37,37,99
1334793180000000000,26,0,0,37,37,100
1334793240000000000,25,0,1,37,37,100
1334793300000000000,25,0,0,38,38,101
1334793360000000000,25,0,0,38,37,100
1334793420000000000,25,0,0,36,38,99
1334793480000000000,25,0,0,36,37,98
1334793540000000000,25,0,0,37,38,100
1334793600000000000,25,0,0,37,38,100
1334793660000000000,25,0,0,36,38,99
1334793720000000000,25,0,0,37,38,100
1334793780000000000,25,0,0,37,37,99
1334793840000000000,25,0,1,37,37,100
1334793900000000000,25,0,0,37,37,99
1334793960000000000,25,0,0,36,37,98
1334794020000000000,25,0,1,36,38,100
1334794080000000000,25,0,0,36,38,99
1334794140000000000,25,0,1,36,39,101
1334794200000000000,25,0,0,36,38,99
1334794260000000000,25,0,0,36,37,98
1334794320000000000,25,0,0,36,38,99
1334794380000000000,26,0,1,36,38,101
1334794440000000000,27,0,0,36,38,101
1334794500000000000,27,0,0,36,38,101
1334794560000000000,25,0,1,36,38,100
1334794620000000000,25,0,0,36,38,99
1334794680000000000,25,0,0,36,37,98
1334794740000000000,25,0,0,37,38,100
1334794800000000000,25,0,0,36,37,98
1334794860000000000,25,0,0,36,38,99
1334794920000000000,25,0,0,37,38,100
1334794980000000000,25,0,127,37,38,227
1334795040000000000,25,0,140,35,38,238
1334795100000000000,25,0,128,36,38,227
1334795160000000000,25,0,127,37,38,227
1334795220000000000,25,0,127,36,38,226
1334795280000000000,25,0,126,36,38,225
1334795340000000000,25,0,124,36,38,223
1334795400000000000,25,0,123,36,39,223
1334795460000000000,25,0,122,35,38,220
1334795520000000000,25,0,122,36,38,221
1334795580000000000,26,0,0,37,38,101
1334795640000000000,25,0,0,35,38,98
1334795700000000000,25,0,0,37,38,100
1334795760000000000,25,0,0,36,38,99
1334795820000000000,25,0,0,36,37,98
1334795880000000000,25,0,0,36,38,99
1334795940000000000,25,0,0,37,38,100
1334796000000000000,26,0,0,35,38,99
1334796060000000000,25,0,7,36,38,106
1334796120000000000,25,0,0,36,38,99
1334796180000000000,26,0,0,37,38,101
1334796240000000000,25,0,0,35,38,98
1334796300000000000,25,0,0,36,38,99
1334796360000000000,25,0,0,36,38,99
1334796420000000000,25,0,0,36,38,99
1334796480000000000,25,0,0,36,38,99
1334796540000000000,25,0,0,37,38,100
1334796600000000000,25,0,0,36,38,99
1334796660000000000,25,0,0,35,38,98
1334796720000000000,27,0,0,36,38,101
1334796780000000000,27,0,0,35,38,100
1334796840000000000,25,0,0,36,38,99
1334796900000000000,25,0,0,36,38,99
1334796960000000000,25,0,0,35,38,98
1334797020000000000,26,0,0,35,38,99
1334797080000000000,26,0,0,37,38,101
1334797140000000000,26,0,0,35,38,99
1334797200000000000,25,0,146,37,38,246
1334797260000000000,25,0,139,37,38,239
1334797320000000000,25,0,128,36,38,227
1334797380000000000,25,0,127,36,37,225
1334797440000000000,25,0,127,36,38,226
1334797500000000000,25,0,125,36,38,224
1334797560000000000,25,0,125,37,38,225
1334797620000000000,25,0,124,36,38,223
1334797680000000000,26,0,122,35,38,221
1334797740000000000,25,0,123,36,37,221
1334797800000000000,25,0,7,36,38,106
1334797860000000000,25,0,7,36,38,106
1334797920000000000,25,0,7,36,38,106
1334797980000000000,25,0,7,37,38,107
1334798040000000000,25,0,7,37,38,107
1334798100000000000,25,0,7,36,38,106
1334798160000000000,25,0,7,36,38,106
1334798220000000000,25,0,7,37,38,107
1334798280000000000,26,0,7,36,38,107
1334798340000000000,25,0,7,37,38,107
1334798400000000000,25,0,132,36,38,231
1334798460000000000,25,0,145,36,38,244
1334798520000000000,25,0,135,37,38,235
1334798580000000000,25,0,135,36,38,234
1334798640000000000,25,0,134,36,37,232
1334798700000000000,25,0,133,36,38,232
1334798760000000000,25,0,134,38,37,234
1334798820000000000,25,0,133,36,38,232
1334798880000000000,25,0,211,36,38,310
1334798940000000000,25,0,132,37,38,232
1334799000000000000,25,0,132,37,38,232
1334799060000000000,26,0,131,36,38,231
1334799120000000000,25,0,131,37,38,231
1334799180000000000,25,0,130,36,38,229
1334799240000000000,25,0,133,36,38,232
1334799300000000000,25,0,135,36,38,234
1334799360000000000,25,0,134,38,38,235
1334799420000000000,25,0,134,36,38,233
1334799480000000000,25,0,133,36,38,232
1334799540000000000,25,0,135,37,38,235
1334799600000000000,25,0,128,36,38,227
1334799660000000000,25,0,127,36,38,226
1334799720000000000,25,0,125,36,38,224
1334799780000000000,25,0,124,36,38,223
1334799840000000000,26,0,123,36,38,223
1334799900000000000,25,0,122,36,38,221
1334799960000000000,25,0,0,37,38,100
1334800020000000000,27,0,0,37,38,102
1334800080000000000,27,0,0,37,38,102
1334800140000000000,25,0,0,37,38,100
1334800200000000000,26,0,0,37,38,101
1334800260000000000,26,0,0,37,38,101
1334800320000000000,25,0,0,36,38,99
1334800380000000000,25,0,1,36,38,100
1334800440000000000,25,0,0,37,38,100
1334800500000000000,26,0,0,36,38,100
1334800560000000000,25,0,0,37,38,100
1334800620000000000,25,0,0,36,38,99
1334800680000000000,25,0,0,38,38,101
1334800740000000000,25,0,0,37,38,100
1334800800000000000,25,0,0,37,37,99
1334800860000000000,25,0,0,37,38,100
1334800920000000000,26,0,0,37,39,102
1334800980000000000,25,0,1,38,39,103
1334801040000000000,25,0,0,36,38,99
1334801100000000000,25,0,0,37,38,100
1334801160000000000,25,0,0,37,38,100
1334801220000000000,25,0,0,36,39,100
1334801280000000000,25,0,0,37,39,101
1334801340000000000,26,0,0,38,38,102
1334801400000000000,25,0,0,37,39,101
1334801460000000000,26,0,0,37,39,102
1334801520000000000,25,0,0,38,39,102
1334801580000000000,25,0,0,36,39,100
1334801640000000000,25,0,0,36,39,100
1334801700000000000,25,0,0,37,39,101
1334801760000000000,25,0,0,37,39,101
1334801820000000000,27,0,0,38,39,104
1334801880000000000,27,0,142,38,39,246
1334801940000000000,25,0,130,36,38,229
1334802000000000000,25,0,127,36,39,227
1334802060000000000,25,0,127,37,38,227
1334802120000000000,25,0,127,37,38,227
1334802180000000000,25,0,125,38,39,227
1334802240000000000,25,0,126,37,39,227
1334802300000000000,25,0,124,38,39,226
1334802360000000000,26,0,123,38,39,226
1334802420000000000,25,0,122,37,38,222
1334802480000000000,25,0,121,38,38,222
1334802540000000000,352,0,0,37,209,598
1334802600000000000,353,0,0,37,286,676
1334802660000000000,353,0,0,37,265,655
1334802720000000000,349,0,1,36,267,653
1334802780000000000,349,0,1,36,238,624
1334802840000000000,348,0,1,36,248,633
1334802900000000000,346,0,0,37,227,610
1334802960000000000,345,0,7,37,231,620
1334803020000000000,345,0,7,36,221,609
1334803080000000000,347,0,7,36,217,607
1334803140000000000,349,0,7,36,219,611
1334803200000000000,355,0,7,36,234,632
1334803260000000000,355,0,6,37,222,620
1334803320000000000,353,0,6,38,241,638
1334803380000000000,354,0,7,38,228,627
1334803440000000000,352,0,156,37,228,773
1334803500000000000,353,0,140,37,246,776
1334803560000000000,352,0,135,37,263,787
1334803620000000000,352,0,134,36,198,720
1334803680000000000,354,0,134,37,269,794
1334803740000000000,352,0,134,37,223,746
1334803800000000000,351,0,132,37,245,765
1334803860000000000,353,0,132,37,217,739
1334803920000000000,352,0,132,36,270,790
1334803980000000000,353,0,132,36,307,828
1334804040000000000,353,0,130,35,254,772
1334804100000000000,352,0,129,38,254,773
1334804160000000000,352,0,129,37,265,783
1334804220000000000,352,0,129,36,253,770
1334804280000000000,352,0,128,36,178,694
1334804340000000000,25,0,129,36,49,239
1334804400000000000,26,0,129,37,49,241
1334804460000000000,25,0,128,37,48,238
1334804520000000000,25,0,130,36,48,239
1334804580000000000,25,0,125,38,49,237
1334804640000000000,25,0,123,36,49,233
1334804700000000000,25,0,122,36,49,232
1334804760000000000,25,0,0,37,48,110
1334804820000000000,25,0,0,37,48,110
1334804880000000000,25,0,0,37,48,110
1334804940000000000,26,0,0,36,49,111
1334805000000000000,25,0,0,37,49,111
1334805060000000000,26,0,0,36,48,110
1334805120000000000,25,0,0,37,49,111
1334805180000000000,25,0,0,36,48,109
1334805240000000000,25,0,0,38,48,111
1334805300000000000,25,0,0,36,48,109
1334805360000000000,25,0,0,37,49,111
1334805420000000000,26,0,0,37,49,112
1334805480000000000,27,0,0,36,48,111
1334805540000000000,25,0,0,35,48,108
1334805600000000000,25,0,0,36,48,109
1334805660000000000,25,0,0,36,48,109
1334805720000000000,25,0,1,37,48,111
1334805780000000000,25,0,0,36,48,109
1334805840000000000,25,0,0,36,48,109
1334805900000000000,25,0,0,38,49,112
1334805960000000000,25,0,0,36,48,109
1334806020000000000,25,0,0,36,48,109
1334806080000000000,25,0,0,36,48,109
1334806140000000000,25,0,0,37,48,110
1334806200000000000,25,0,0,37,48,110
1334806260000000000,25,0,0,36,49,110
1334806320000000000,25,0,0,37,49,111
1334806380000000000,25,0,1,36,37,99
1334806440000000000,25,0,0,36,38,99
1334806500000000000,25,0,0,36,38,99
1334806560000000000,25,0,0,36,38,99
1334806620000000000,25,0,123,38,37,223
1334806680000000000,25,0,140,36,38,239
1334806740000000000,25,0,130,36,38,229
1334806800000000000,25,0,126,36,38,225
1334806860000000000,25,0,126,35,38,224
1334806920000000000,25,0,125,38,38,226
1334806980000000000,25,0,124,37,38,224
1334807040000000000,25,0,124,36,38,223
1334807100000000000,25,0,124,38,38,225
1334807160000000000,25,0,121,36,38,220
1334807220000000000,26,0,121,36,38,221
1334807280000000000,26,0,0,36,38,100
1334807340000000000,27,0,1,35,38,101
1334807400000000000,25,0,0,36,38,99
1334807460000000000,25,0,0,36,37,98
1334807520000000000,25,0,0,38,38,101
1334807580000000000,25,0,0,37,38,100
1334807640000000000,25,0,0,36,37,98
1334807700000000000,26,0,0,36,38,100
1334807760000000000,25,0,0,36,38,99
1334807820000000000,25,0,0,36,38,99
1334807880000000000,25,0,0,36,38,99
1334807940000000000,25,0,0,37,38,100
1334808000000000000,25,0,0,36,38,99
1334808060000000000,25,0,0,36,38,99
1334808120000000000,25,0,10,35,38,108
1334808180000000000,25,0,8,37,38,108
1334808240000000000,25,0,0,37,38,100
1334808300000000000,25,0,0,36,38,99
1334808360000000000,25,0,0,36,38,99
1334808420000000000,25,0,0,37,38,100
1334808480000000000,25,0,0,36,39,100
1334808540000000000,25,0,0,36,38,99
1334808600000000000,25,0,0,37,39,101
1334808660000000000,25,0,0,36,38,99
1334808720000000000,25,0,0,37,37,99
1334808780000000000,25,0,0,37,38,100
1334808840000000000,25,0,0,36,38,99
1334808900000000000,25,0,0,37,38,100
1334808960000000000,25,0,0,38,38,101
1334809020000000000,25,0,149,36,38,248
1334809080000000000,27,0,135,37,38,237
1334809140000000000,27,0,127,36,38,228
1334809200000000000,26,0,126,36,38,226
1334809260000000000,25,0,125,37,38,225
1334809320000000000,25,0,124,37,38,224
1334809380000000000,25,0,123,36,39,223
1334809440000000000,25,0,122,38,39,224
1334809500000000000,25,0,122,37,38,222
1334809560000000000,25,0,122,36,38,221
1334809620000000000,25,0,122,36,38,221
1334809680000000000,25,0,0,36,38,99
1334809740000000000,26,0,0,36,38,100
1334809800000000000,25,0,0,38,38,101
1334809860000000000,25,0,0,36,39,100
1334809920000000000,25,0,0,37,39,101
1334809980000000000,25,0,0,37,39,101
1334810040000000000,25,0,0,37,38,100
1334810100000000000,25,0,0,37,39,101
1334810160000000000,25,0,0,37,38,100
1334810220000000000,25,0,0,37,38,100
1334810280000000000,25,0,0,38,38,101
1334810340000000000,25,0,0,36,39,100
1334810400000000000,26,0,0,38,38,102
1334810460000000000,25,0,0,37,38,100
1334810520000000000,25,0,7,37,38,107
1334810580000000000,25,0,7,37,38,107
1334810640000000000,25,0,7,36,38,106
1334810700000000000,25,0,7,37,39,108
1334810760000000000,25,0,7,37,38,107
1334810820000000000,25,0,7,37,38,107
1334810880000000000,25,0,7,37,38,107
1334810940000000000,27,0,154,36,38,255
1334811000000000000,25,0,140,36,38,239
1334811060000000000,25,0,135,36,38,234
1334811120000000000,25,0,134,37,38,234
1334811180000000000,25,0,134,38,37,234
1334811240000000000,25,0,133,36,38,232
1334811300000000000,25,0,132,37,38,232
1334811360000000000,25,0,132,37,38,232
1334811420000000000,25,0,131,37,39,232
1334811480000000000,25,0,132,36,38,231
1334811540000000000,25,0,130,36,38,229
1334811600000000000,25,0,148,36,38,247
1334811660000000000,25,0,131,36,38,230
1334811720000000000,25,0,131,37,38,231
1334811780000000000,25,0,131,37,38,231
1334811840000000000,26,0,132,36,38,232
1334811900000000000,25,0,132,36,38,231
1334811960000000000,25,0,132,36,38,231
1334812020000000000,25,0,131,37,38,231
1334812080000000000,25,0,130,37,38,230
1334812140000000000,25,0,129,37,37,228
1334812200000000000,26,0,128,36,37,227
1334812260000000000,25,0,128,37,38,228
1334812320000000000,26,0,127,36,38,227
1334812380000000000,25,0,128,37,38,228
1334812440000000000,25,0,127,37,38,227
1334812500000000000,25,0,128,37,38,228
1334812560000000000,25,0,127,36,38,226
1334812620000000000,26,0,127,36,38,227
1334812680000000000,26,0,126,37,38,227
1334812740000000000,26,0,6,37,38,107
1334812800000000000,351,0,6,36,146,539
1334812860000000000,349,0,7,36,253,645
1334812920000000000,348,0,6,37,208,599
1334812980000000000,348,0,7,36,284,675
1334813040000000000,350,0,6,36,216,608
1334813100000000000,347,0,0,37,243,627
1334813160000000000,347,0,0,37,225,609
1334813220000000000,345,0,0,36,279,660
1334813280000000000,345,0,0,36,218,599
1334813340000000000,347,0,0,36,229,612
1334813400000000000,348,0,144,36,216,744
1334813460000000000,345,0,129,36,219,729
1334813520000000000,347,0,127,37,283,794
1334813580000000000,347,0,125,36,387,895
1334813640000000000,346,0,124,36,380,886
1334813700000000000,343,0,122,36,209,710
1334813760000000000,343,0,121,36,282,782
1334813820000000000,340,0,121,36,239,736
1334813880000000000,341,0,119,35,244,739
1334813940000000000,343,0,119,36,273,771
1334814000000000000,344,0,0,37,213,594
1334814060000000000,351,0,0,37,253,641
1334814120000000000,330,0,0,36,334,700
1334814180000000000,332,0,0,36,384,752
1334814240000000000,332,0,0,37,228,597
1334814300000000000,330,0,0,36,246,612
1334814360000000000,334,0,0,37,292,663
1334814420000000000,334,0,0,37,255,626
1334814480000000000,332,0,0,36,309,677
1334814540000000000,334,0,0,38,244,616
1334814600000000000,334,0,0,37,223,594
1334814660000000000,333,0,0,37,371,741
1334814720000000000,330,0,0,36,388,754
1334814780000000000,332,0,0,36,203,571
1334814840000000000,334,0,0,36,252,622
1334814900000000000,332,0,0,37,228,597
1334814960000000000,332,0,0,37,368,737
1334815020000000000,332,0,0,36,300,668
1334815080000000000,333,0,0,36,207,576
1334815140000000000,333,0,0,38,239,610
1334815200000000000,332,0,0,36,400,768
1334815260000000000,334,0,0,37,229,600
1334815320000000000,333,0,0,37,248,618
1334815380000000000,335,0,0,36,242,613
1334815440000000000,333,0,0,36,217,586
1334815500000000000,336,0,0,38,255,629
1334815560000000000,334,0,0,37,218,589
1334815620000000000,333,0,0,36,219,588
1334815680000000000,331,0,0,37,252,620
1334815740000000000,331,0,0,36,238,605
1334815800000000000,329,0,0,36,266,631
1334815860000000000,329,0,0,36,253,618
1334815920000000000,327,0,0,37,327,691
1334815980000000000,326,0,0,37,253,616
1334816040000000000,327,0,0,36,288,651
1334816100000000000,327,0,0,37,254,618
1334816160000000000,328,0,0,36,301,665
1334816220000000000,331,0,143,35,247,756
1334816280000000000,332,0,136,35,252,755
1334816340000000000,331,0,126,37,228,722
1334816400000000000,331,0,126,36,250,743
1334816460000000000,332,0,124,37,244,737
1334816520000000000,332,0,125,36,239,732
1334816580000000000,332,0,127,36,292,787
1334816640000000000,333,0,127,36,257,753
1334816700000000000,335,0,127,37,248,747
1334816760000000000,336,0,127,37,243,743
1334816820000000000,336,0,128,37,224,725
1334816880000000000,336,0,127,38,389,890
1334816940000000000,336,0,128,38,264,766
1334817000000000000,335,0,127,38,356,856
1334817060000000000,337,0,127,38,246,748
1334817120000000000,334,0,127,37,225,723
1334817180000000000,335,0,7,37,241,620
1334817240000000000,334,0,7,37,223,601
1334817300000000000,336,0,7,36,233,612
1334817360000000000,335,0,7,37,247,626
1334817420000000000,334,0,6,36,245,621
1334817480000000000,334,0,6,36,235,611
1334817540000000000,336,0,6,37,221,600
1334817600000000000,334,0,6,36,312,688
1334817660000000000,334,0,6,36,232,608
1334817720000000000,335,0,6,37,247,625
1334817780000000000,335,0,151,37,243,766
1334817840000000000,336,0,136,38,237,747
1334817900000000000,336,0,134,38,229,737
1334817960000000000,335,0,133,37,300,805
1334818020000000000,333,0,133,36,235,737
1334818080000000000,330,0,131,37,240,738
1334818140000000000,330,0,130,37,267,764
1334818200000000000,329,0,129,37,268,763
1334818260000000000,328,0,128,37,234,727
1334818320000000000,327,0,131,36,386,880
1334818380000000000,332,0,126,37,393,888
1334818440000000000,331,0,124,36,217,708
1334818500000000000,332,0,122,37,313,804
1334818560000000000,331,0,121,1513,395,2360
1334818620000000000,331,0,120,1642,216,2309
1334818680000000000,331,0,120,1698,232,2381
1334818740000000000,333,0,0,1730,223,2286
1334818800000000000,331,0,0,1758,242,2331
1334818860000000000,332,0,0,1777,76,2185
1334818920000000000,7,0,0,1785,36,1828
1334818980000000000,8,0,0,1767,37,1812
1334819040000000000,7,0,0,1773,37,1817
1334819100000000000,7,0,0,1781,37,1825
1334819160000000000,8,0,0,1783,37,1828
1334819220000000000,8,0,0,1783,37,1828
1334819280000000000,8,0,0,1791,37,1836
1334819340000000000,7,0,0,1792,37,1836
1334819400000000000,8,0,1,1799,37,1845
1334819460000000000,7,0,0,1799,37,1843
1334819520000000000,7,0,1,1801,38,1847
1334819580000000000,7,0,0,1806,37,1850
1334819640000000000,7,0,0,1809,38,1854
1334819700000000000,7,0,0,1,37,45
1334819760000000000,7,0,0,0,38,45
1334819820000000000,7,0,0,1,37,45
1334819880000000000,7,0,0,1,37,45
1334819940000000000,7,0,0,1,37,45
1334820000000000000,7,0,1,1,37,46
1334820060000000000,7,0,0,1,38,46
1334820120000000000,7,0,0,1,38,46
1334820180000000000,7,0,0,1,37,45
1334820240000000000,7,0,0,1,38,46
1334820300000000000,7,0,0,1,37,45
1334820360000000000,7,0,1,1,38,47
1334820420000000000,7,0,0,1,37,45
1334820480000000000,7,0,0,1,38,46
1334820540000000000,7,0,0,1,37,45
1334820600000000000,7,0,0,39,37,83
1334820660000000000,7,0,0,39,38,84
1334820720000000000,7,0,1,39,37,84
1334820780000000000,7,0,0,38,37,82
1334820840000000000,7,0,146,38,37,228
1334820900000000000,7,0,132,37,38,214
1334820960000000000,7,0,127,38,37,209
1334821020000000000,7,0,127,38,38,210
1334821080000000000,7,0,125,38,37,207
1334821140000000000,7,0,125,38,38,208
1334821200000000000,7,0,124,38,37,206
1334821260000000000,7,0,125,38,37,207
1334821320000000000,7,0,124,39,37,207
1334821380000000000,7,0,122,38,38,205
1334821440000000000,7,0,0,38,38,83
1334821500000000000,7,0,0,39,38,84
1334821560000000000,7,0,0,38,38,83
1334821620000000000,7,0,0,38,38,83
1334821680000000000,7,0,0,37,38,82
1334821740000000000,7,0,0,37,38,82
1334821800000000000,7,0,1,37,38,83
1334821860000000000,7,0,1,38,38,84
1334821920000000000,7,0,10,37,38,92
1334821980000000000,7,0,10,38,37,92
1334822040000000000,7,0,0,38,37,82
1334822100000000000,7,0,0,38,37,82
1334822160000000000,7,0,1,38,38,84
1334822220000000000,7,0,0,1541,37,1585
1334822280000000000,7,0,0,1688,37,1732
1334822340000000000,7,0,0,1741,37,1785
1334822400000000000,7,0,0,1770,38,1815
1334822460000000000,7,0,0,1787,37,1831
1334822520000000000,7,0,1,1795,37,1840
1334822580000000000,7,0,0,1770,37,1814
1334822640000000000,7,0,0,1770,38,1815
1334822700000000000,7,0,0,1783,38,1828
1334822760000000000,7,0,0,1785,37,1829
1334822820000000000,7,0,0,1794,38,1839
1334822880000000000,7,0,0,1799,37,1843
1334822940000000000,7,0,0,1794,38,1839
1334823000000000000,7,0,0,1802,38,1847
1334823060000000000,7,0,0,1800,39,1846
1334823120000000000,7,0,0,1808,37,1852
1334823180000000000,7,0,0,1806,37,1850
1334823240000000000,7,0,0,1815,38,1860
1334823300000000000,7,0,147,1806,37,1997
1334823360000000000,7,0,132,1807,37,1983
1334823420000000000,7,0,129,1809,37,1982
1334823480000000000,7,0,129,1,37,174
1334823540000000000,7,0,127,1,37,172
1334823600000000000,7,0,126,1,38,172
1334823660000000000,7,0,125,1,38,171
1334823720000000000,7,0,124,1,38,170
1334823780000000000,7,0,122,1,37,167
1334823840000000000,8,0,126,1,37,172
1334823900000000000,7,0,7,1,37,52
1334823960000000000,7,0,8,1,37,53
1334824020000000000,7,0,7,1,37,52
1334824080000000000,7,0,7,1,38,53
1334824140000000000,7,0,7,1,37,52
1334824200000000000,7,0,7,1,37,52
1334824260000000000,7,0,7,1,37,52
1334824320000000000,7,0,7,1,38,53
1334824380000000000,7,0,7,1,38,53
1334824440000000000,7,0,7,0,37,51
1334824500000000000,7,0,7,41,37,92
1334824560000000000,7,0,136,38,37,218
1334824620000000000,7,0,146,37,37,227
1334824680000000000,7,0,137,38,37,219
1334824740000000000,7,0,135,37,37,216
1334824800000000000,7,0,135,38,37,217
1334824860000000000,7,0,133,38,38,216
1334824920000000000,7,0,133,38,38,216
1334824980000000000,7,0,132,38,37,214
1334825040000000000,7,0,132,37,38,214
1334825100000000000,7,0,131,38,38,214
1334825160000000000,7,0,131,38,38,214
1334825220000000000,7,0,130,38,37,212
1334825280000000000,7,0,130,38,38,213
1334825340000000000,7,0,129,38,37,211
1334825400000000000,7,0,129,38,38,212
1334825460000000000,7,0,130,38,37,212
1334825520000000000,7,0,129,38,38,212
1334825580000000000,7,0,128,38,37,210
1334825640000000000,7,0,127,38,38,210
1334825700000000000,7,0,125,38,37,207
1334825760000000000,7,0,123,37,38,205
1334825820000000000,7,0,1,37,37,82
1334825880000000000,7,0,0,1444,38,1489
1334825940000000000,7,0,0,1649,37,1693
1334826000000000000,7,0,0,1739,37,1783
1334826060000000000,7,0,0,1762,38,1807
1334826120000000000,7,0,1,1783,37,1828
1334826180000000000,7,0,0,1799,38,1844
1334826240000000000,7,0,0,1771,38,1816
1334826300000000000,7,0,0,1773,38,1818
1334826360000000000,7,0,0,1782,37,1826
1334826420000000000,7,0,0,1791,37,1835
1334826480000000000,7,0,0,1794,37,1838
1334826540000000000,7,0,0,1792,38,1837
1334826600000000000,7,0,0,1797,38,1842
1334826660000000000,7,0,0,1795,37,1839
1334826720000000000,7,0,0,1805,38,1850
1334826780000000000,7,0,0,1803,37,1847
1334826840000000000,7,0,0,1806,37,1850
1334826900000000000,7,0,0,1810,38,1855
1334826960000000000,7,0,0,1809,38,1854
1334827020000000000,7,0,0,1814,38,1859
1334827080000000000,7,0,0,1817,38,1862
1334827140000000000,7,0,0,1815,37,1859
1334827200000000000,7,0,0,1815,37,1859
1334827260000000000,7,0,1,1809,37,1854
1334827320000000000,7,0,1,1,37,46
1334827380000000000,7,0,0,1,38,46
1334827440000000000,7,0,0,1,37,45
1334827500000000000,7,0,0,0,38,45
1334827560000000000,7,0,0,1,37,45
1334827620000000000,7,0,0,1,37,45
1334827680000000000,7,0,1,1,37,46
1334827740000000000,7,0,1,1,38,47
1334827800000000000,7,0,0,1,38,46
1334827860000000000,7,0,146,1,37,191
1334827920000000000,7,0,135,1,38,181
1334827980000000000,7,0,128,1,37,173
1334828040000000000,7,0,129,1,38,175
1334828100000000000,7,0,127,1,37,172
1334828160000000000,7,0,125,1,37,170
1334828220000000000,7,0,124,1,37,169
1334828280000000000,7,0,123,41,38,209
1334828340000000000,7,0,125,41,37,210
1334828400000000000,7,0,122,39,38,206
1334828460000000000,7,0,0,38,37,82
1334828520000000000,7,0,0,38,38,83
1334828580000000000,7,0,0,38,38,83
1334828640000000000,7,0,0,37,37,81
1334828700000000000,7,0,0,38,39,84
1334828760000000000,7,0,0,37,38,82
1334828820000000000,7,0,0,37,38,82
1334828880000000000,7,0,0,38,37,82
1334828940000000000,7,0,0,38,37,82
1334829000000000000,7,0,0,38,37,82
1334829060000000000,7,0,0,39,37,83
1334829120000000000,7,0,0,38,38,83
1334829180000000000,7,0,0,38,37,82
1334829240000000000,7,0,7,38,38,90
1334829300000000000,7,0,0,38,38,83
1334829360000000000,7,0,0,38,38,83
1334829420000000000,7,0,0,37,38,82
1334829480000000000,7,0,0,38,38,83
1334829540000000000,7,0,0,38,38,83
1334829600000000000,7,0,0,1311,37,1355
1334829660000000000,7,0,0,1590,37,1634
1334829720000000000,7,0,0,1717,37,1761
1334829780000000000,7,0,0,1755,37,1799
1334829840000000000,7,0,0,1775,37,1819
1334829900000000000,7,0,0,1793,37,1837
1334829960000000000,7,0,0,1766,38,1811
1334830020000000000,7,0,0,1782,37,1826
1334830080000000000,7,0,1,1787,38,1833
1334830140000000000,7,0,0,1791,38,1836
1334830200000000000,7,0,0,1799,38,1844
1334830260000000000,7,0,0,1800,37,1844
1334830320000000000,7,0,144,1805,37,1993
1334830380000000000,7,0,139,1810,37,1993
1334830440000000000,7,0,129,1809,38,1983
1334830500000000000,7,0,129,1811,37,1984
1334830560000000000,7,0,126,1817,37,1987
1334830620000000000,7,0,126,1817,37,1987
1334830680000000000,7,0,125,1819,38,1989
1334830740000000000,7,0,124,1818,38,1987
1334830800000000000,7,0,123,1819,37,1986
1334830860000000000,7,0,122,1818,37,1984
1334830920000000000,7,0,122,1819,37,1985
1334830980000000000,7,0,0,1818,37,1862
1334831040000000000,7,0,0,1,37,45
1334831100000000000,7,0,0,1,38,46
1334831160000000000,7,0,0,1,37,45
1334831220000000000,7,0,0,1,37,45
1334831280000000000,7,0,1,1,37,46
1334831340000000000,7,0,0,1,37,45
1334831400000000000,7,0,0,1,37,45
1334831460000000000,7,0,1,1,37,46
1334831520000000000,7,0,0,1,38,46
1334831580000000000,7,0,0,1,38,46
1334831640000000000,8,0,1,1,38,48
1334831700000000000,7,0,1,1,38,47
1334831760000000000,7,0,0,1,37,45
1334831820000000000,7,0,0,1,38,46
1334831880000000000,7,0,0,1,37,45
1334831940000000000,7,0,7,1,37,52
1334832000000000000,7,0,7,0,38,52
1334832060000000000,7,0,7,1,38,53
1334832120000000000,7,0,7,43,37,94
1334832180000000000,7,0,7,39,38,91
1334832240000000000,7,0,7,39,37,90
1334832300000000000,7,0,7,38,38,90
1334832360000000000,7,0,154,38,37,236
1334832420000000000,7,0,140,37,37,221
1334832480000000000,7,0,136,38,37,218
1334832540000000000,7,0,135,38,37,217
1334832600000000000,7,0,135,38,38,218
1334832660000000000,7,0,133,38,37,215
1334832720000000000,7,0,133,38,38,216
1334832780000000000,7,0,132,37,37,213
1334832840000000000,7,0,132,38,38,215
1334832900000000000,7,0,131,38,37,213
1334832960000000000,7,0,131,38,37,213
1334833020000000000,7,0,130,1017,37,1191
1334833080000000000,7,0,130,1582,38,1757
1334833140000000000,7,0,130,1713,37,1887
1334833200000000000,7,0,129,1763,38,1937
1334833260000000000,7,0,129,1785,37,1958
1334833320000000000,7,0,129,1801,37,1974
1334833380000000000,7,0,129,1770,38,1944
1334833440000000000,7,0,128,1786,38,1959
1334833500000000000,7,0,129,1791,37,1964
1334833560000000000,7,0,128,1799,37,1971
1334833620000000000,7,0,127,1802,37,1973
1334833680000000000,7,0,124,1808,37,1976
1334833740000000000,7,0,0,1811,38,1856
1334833800000000000,7,0,1,1814,37,1859
1334833860000000000,7,0,0,1815,38,1860
1334833920000000000,7,0,0,1815,37,1859
1334833980000000000,7,0,0,1819,38,1864
1334834040000000000,7,0,0,1818,37,1862
1334834100000000000,7,0,0,1821,38,1866
1334834160000000000,7,0,1,1822,38,1868
1334834220000000000,7,0,0,1823,37,1867
1334834280000000000,7,0,0,1823,38,1868
1334834340000000000,7,0,0,1826,38,1871
1334834400000000000,7,0,0,1,38,46
1334834460000000000,7,0,0,1,38,46
1334834520000000000,7,0,0,1,38,46
1334834580000000000,7,0,0,1,38,46
1334834640000000000,7,0,0,1,38,46
1334834700000000000,7,0,1,1,37,46
1334834760000000000,7,0,0,1,37,45
1334834820000000000,7,0,0,1,38,46
1334834880000000000,7,0,0,1,38,46
1334834940000000000,7,0,1,1,37,46
1334835000000000000,7,0,0,1,38,46
1334835060000000000,7,0,0,1,37,45
1334835120000000000,7,0,0,1,38,46
1334835180000000000,7,0,1,1,37,46
1334835240000000000,7,0,0,1,37,45
1334835300000000000,7,0,0,1,38,46
1334835360000000000,7,0,0,1,38,46
1334835420000000000,7,0,0,41,38,86
1334835480000000000,7,0,1,39,38,85
1334835540000000000,7,0,0,39,38,84
1334835600000000000,7,0,144,37,38,226
1334835660000000000,7,0,132,38,37,214
1334835720000000000,7,0,127,38,37,209
1334835780000000000,7,0,127,39,37,210
1334835840000000000,7,0,126,38,37,208
1334835900000000000,7,0,124,38,37,206
1334835960000000000,7,0,124,38,37,206
1334836020000000000,7,0,124,37,37,205
1334836080000000000,7,0,122,37,37,203
1334836140000000000,7,0,122,37,38,204
1334836200000000000,7,0,0,38,38,83
1334836260000000000,7,0,0,38,37,82
1334836320000000000,7,0,0,38,37,82
1334836380000000000,7,0,1,37,37,82
1334836440000000000,7,0,0,38,38,83
1334836500000000000,7,0,0,38,38,83
1334836560000000000,7,0,0,38,37,82
1334836620000000000,7,0,0,38,37,82
1334836680000000000,7,0,0,1386,37,1430
1334836740000000000,7,0,0,1631,38,1676
1334836800000000000,7,0,0,1736,38,1781
1334836860000000000,7,0,0,1762,37,1806
1334836920000000000,7,0,0,1784,37,1828
1334836980000000000,7,0,1,1803,37,1848
1334837040000000000,7,0,1,1773,37,1818
1334837100000000000,7,0,0,1782,38,1827
1334837160000000000,7,0,0,1791,37,1835
1334837220000000000,7,0,7,1793,37,1844
1334837280000000000,7,0,0,1803,37,1847
1334837340000000000,7,0,0,1800,37,1844
1334837400000000000,7,0,0,1810,38,1855
1334837460000000000,7,0,0,1808,37,1852
1334837520000000000,7,0,0,1814,37,1858
1334837580000000000,7,0,0,1811,38,1856
1334837640000000000,7,0,0,1815,38,1860
1334837700000000000,7,0,0,1816,37,1860
1334837760000000000,7,0,0,1817,38,1862
1334837820000000000,7,0,0,1821,38,1866
1334837880000000000,7,0,0,1822,38,1867
1334837940000000000,7,0,0,1823,37,1867
1334838000000000000,7,0,0,1825,38,1870
1334838060000000000,7,0,146,1822,38,2013
1334838120000000000,7,0,140,1825,37,2009
1334838180000000000,7,0,129,1827,38,2001
1334838240000000000,7,0,127,171,38,343
1334838300000000000,7,0,126,1,38,172
1334838360000000000,7,0,125,0,38,170
1334838420000000000,7,0,124,1,37,169
1334838480000000000,7,0,123,1,38,169
1334838540000000000,7,0,123,1,38,169
1334838600000000000,7,0,121,1,38,167
1334838660000000000,7,0,121,0,37,165
1334838720000000000,7,0,0,1,37,45
1334838780000000000,7,0,0,0,38,45
1334838840000000000,7,0,0,1,37,45
1334838900000000000,7,0,0,1,38,46
1334838960000000000,7,0,0,1,38,46
1334839020000000000,7,0,0,1,38,46
1334839080000000000,7,0,0,1,38,46
1334839140000000000,7,0,0,1,37,45
1334839200000000000,7,0,0,1,38,46
1334839260000000000,7,0,0,39,37,83
1334839320000000000,7,0,0,41,37,85
1334839380000000000,7,0,0,38,37,82
1334839440000000000,7,0,0,38,37,82
1334839500000000000,7,0,0,39,38,84
1334839560000000000,7,0,0,38,38,83
1334839620000000000,7,0,0,38,38,83
1334839680000000000,7,0,0,38,38,83
1334839740000000000,7,0,1,38,37,83
1334839800000000000,7,0,1,38,38,84
1334839860000000000,7,0,0,37,38,82
1334839920000000000,7,0,0,37,37,81
1334839980000000000,7,0,0,38,38,83
1334840040000000000,7,0,1,38,38,84
1334840100000000000,7,0,0,37,38,82
1334840160000000000,7,0,0,37,37,81
1334840220000000000,7,0,1,38,37,83
1334840280000000000,7,0,1,38,38,84
1334840340000000000,7,0,0,38,37,82
1334840400000000000,7,0,0,38,38,83
1334840460000000000,7,0,1,1511,38,1557
1334840520000000000,7,0,0,1680,37,1724
1334840580000000000,7,0,0,1753,38,1798
1334840640000000000,7,0,0,1786,37,1830
1334840700000000000,7,0,1,1800,37,1845
1334840760000000000,7,0,0,1775,37,1819
1334840820000000000,7,0,1,1785,37,1830
1334840880000000000,7,0,7,1786,37,1837
1334840940000000000,7,0,151,1795,37,1990
1334841000000000000,7,0,138,1800,38,1983
1334841060000000000,7,0,135,1806,37,1985
1334841120000000000,7,0,133,1809,37,1986
1334841180000000000,7,0,133,1811,38,1989
1334841240000000000,7,0,132,1811,37,1987
1334841300000000000,7,0,132,1816,38,1993
1334841360000000000,7,0,132,1818,37,1994
1334841420000000000,7,0,130,1818,37,1992
1334841480000000000,7,0,131,1822,37,1997
1334841540000000000,7,0,129,1822,37,1995
1334841600000000000,7,0,129,1824,38,1998
1334841660000000000,7,0,129,1829,37,2002
1334841720000000000,7,0,129,1826,37,1999
1334841780000000000,7,0,128,1829,37,2001
1334841840000000000,7,0,128,1831,37,2003
1334841900000000000,7,0,129,1,37,174
1334841960000000000,7,0,128,1,38,174
1334842020000000000,7,0,128,0,38,173
1334842080000000000,7,0,128,1,38,174
1334842140000000000,7,0,127,1,37,172
1334842200000000000,7,0,127,1,38,173
1334842260000000000,7,0,127,1,37,172
1334842320000000000,7,0,7,1,37,52
1334842380000000000,7,0,7,1,37,52
1334842440000000000,7,0,7,1,37,52
1334842500000000000,7,0,0,1,37,45
1334842560000000000,7,0,0,1,37,45
1334842620000000000,7,0,0,1,38,46
1334842680000000000,7,0,0,1,38,46
1334842740000000000,7,0,0,1,38,46
1334842800000000000,7,0,0,0,37,44
1334842860000000000,7,0,0,0,37,44
1334842920000000000,7,0,0,38,38,83
1334842980000000000,7,0,1,38,37,83
1334843040000000000,7,0,0,38,38,83
1334843100000000000,7,0,0,38,37,82
1334843160000000000,7,0,147,37,37,228
1334843220000000000,7,0,138,37,37,219
1334843280000000000,7,0,127,37,37,208
1334843340000000000,7,0,127,36,37,207
1334843400000000000,7,0,126,36,37,206
1334843460000000000,7,0,123,36,37,203
1334843520000000000,7,0,122,37,37,203
1334843580000000000,7,0,121,36,38,202
1334843640000000000,7,0,122,36,38,203
1334843700000000000,7,0,120,36,37,200
1334843760000000000,7,0,0,38,37,82
1334843820000000000,7,0,0,37,37,81
1334843880000000000,7,0,0,37,38,82
1334843940000000000,7,0,0,36,38,81
1334844000000000000,7,0,0,36,37,80
1334844060000000000,7,0,0,36,37,80
1334844120000000000,7,0,0,37,37,81
1334844180000000000,7,0,0,1463,37,1507
1334844240000000000,7,0,0,1658,37,1702
1334844300000000000,7,0,0,1750,38,1795
1334844360000000000,7,0,0,1776,37,1820
1334844420000000000,7,0,1,1789,37,1834
1334844480000000000,7,0,0,1768,37,1812
1334844540000000000,7,0,0,1782,37,1826
1334844600000000000,7,0,0,1791,38,1836
1334844660000000000,7,0,0,1801,38,1846
1334844720000000000,7,0,0,1806,37,1850
1334844780000000000,7,0,0,1810,37,1854
1334844840000000000,7,0,0,1814,37,1858
1334844900000000000,7,0,1,1816,38,1862
1334844960000000000,7,0,0,1817,38,1862
1334845020000000000,7,0,0,1817,37,1861
1334845080000000000,7,0,0,1823,38,1868
1334845140000000000,7,0,0,1825,38,1870
1334845200000000000,7,0,0,1826,37,1870
1334845260000000000,7,0,0,1823,37,1867
1334845320000000000,7,0,0,1829,37,1873
1334845380000000000,7,0,0,1827,37,1871
1334845440000000000,7,0,0,1825,38,1870
1334845500000000000,7,0,0,1827,38,1872
1334845560000000000,7,0,0,1834,37,1878
1334845620000000000,7,0,0,1,37,45
1334845680000000000,7,0,0,1,38,46
1334845740000000000,7,0,1,1,38,47
1334845800000000000,7,0,0,1,37,45
1334845860000000000,7,0,0,1,37,45
1334845920000000000,7,0,0,1,38,46
1334845980000000000,7,0,0,1,37,45
1334846040000000000,7,0,7,1,37,52
1334846100000000000,7,0,146,1,37,191
1334846160000000000,7,0,132,1,38,178
1334846220000000000,7,0,129,1,37,174
1334846280000000000,7,0,127,0,37,171
1334846340000000000,7,0,127,1,40,175
1334846400000000000,7,0,127,1,38,173
1334846460000000000,7,0,124,0,37,168
1334846520000000000,7,0,125,1,37,170
1334846580000000000,7,0,122,1,38,168
1334846640000000000,7,0,122,1,37,167
1334846700000000000,7,0,1,42,38,88
1334846760000000000,7,0,0,37,38,82
1334846820000000000,7,0,0,37,37,81
1334846880000000000,7,0,0,38,37,82
1334846940000000000,7,0,0,37,38,82
1334847000000000000,7,0,0,38,38,83
1334847060000000000,7,0,0,37,37,81
1334847120000000000,7,0,0,37,37,81
1334847180000000000,7,0,0,37,37,81
1334847240000000000,7,0,0,37,38,82
1334847300000000000,7,0,0,38,37,82
1334847360000000000,7,0,0,38,38,83
1334847420000000000,7,0,0,38,38,83
1334847480000000000,7,0,0,38,37,82
1334847540000000000,7,0,0,37,38,82
1334847600000000000,7,0,0,37,37,81
1334847660000000000,7,0,0,37,38,82
1334847720000000000,7,0,0,37,37,81
1334847780000000000,7,0,0,37,38,82
1334847840000000000,7,0,0,38,38,83
1334847900000000000,7,0,1,38,38,84
1334847960000000000,7,0,0,36,37,80
1334848020000000000,7,0,0,37,38,82
1334848080000000000,7,0,1,37,38,83
1334848140000000000,7,0,0,37,38,82
1334848200000000000,7,0,1,37,38,83
1334848260000000000,7,0,1,36,37,81
1334848320000000000,7,0,0,37,38,82
1334848380000000000,7,0,0,38,37,82
1334848440000000000,7,0,0,37,38,82
1334848500000000000,7,0,0,37,37,81
1334848560000000000,7,0,1,36,37,81
1334848620000000000,7,0,0,1293,37,1337
1334848680000000000,7,0,0,1618,37,1662
1334848740000000000,7,0,0,1726,37,1770
1334848800000000000,7,0,1,1778,37,1823
1334848860000000000,7,0,1,1794,37,1839
1334848920000000000,7,0,1,1781,37,1826
1334848980000000000,8,0,798,1784,38,2628
1334849040000000000,7,0,141,1798,37,1983
1334849100000000000,7,0,130,1805,37,1979
1334849160000000000,7,0,127,1808,37,1979
1334849220000000000,7,0,127,1819,37,1990
1334849280000000000,7,0,125,1819,38,1989
1334849340000000000,7,0,126,1811,38,1982
1334849400000000000,7,0,124,1814,38,1983
1334849460000000000,7,0,122,1815,37,1981
1334849520000000000,7,0,123,1831,37,1998
1334849580000000000,7,0,122,1824,39,1992
1334849640000000000,7,0,0,1818,37,1862
1334849700000000000,7,0,10,1827,37,1881
1334849760000000000,7,0,0,1835,37,1879
1334849820000000000,7,0,0,1837,37,1881
1334849880000000000,7,0,1,172,37,217
1334849940000000000,7,0,1,1,38,47
1334850000000000000,7,0,0,1,37,45
1334850060000000000,7,0,0,1,38,46
1334850120000000000,7,0,0,1,37,45
1334850180000000000,8,0,1,1,38,48
1334850240000000000,7,0,0,1,37,45
1334850300000000000,7,0,0,1,37,45
1334850360000000000,7,0,0,1,37,45
1334850420000000000,7,0,1,1,38,47
1334850480000000000,7,0,0,1,37,45
1334850540000000000,7,0,0,1,37,45
1334850600000000000,7,0,0,1,37,45
1334850660000000000,7,0,1,0,37,45
1334850720000000000,7,0,10,1,38,56
1334850780000000000,7,0,7,1,37,52
1334850840000000000,7,0,7,1,38,53
1334850900000000000,7,0,7,1,38,53
1334850960000000000,7,0,7,41,37,92
1334851020000000000,7,0,714,37,37,795
1334851080000000000,7,0,144,38,37,226
1334851140000000000,7,0,137,39,37,220
1334851200000000000,7,0,135,36,37,215
1334851260000000000,7,0,134,37,38,216
1334851320000000000,7,0,133,38,37,215
1334851380000000000,7,0,132,37,38,214
1334851440000000000,7,0,133,38,38,216
1334851500000000000,7,0,131,36,38,212
1334851560000000000,7,0,131,37,37,212
1334851620000000000,7,0,131,37,37,212
1334851680000000000,7,0,129,37,37,210
1334851740000000000,7,0,130,36,37,210
1334851800000000000,7,0,129,37,37,210
1334851860000000000,7,0,130,36,38,211
1334851920000000000,7,0,128,38,37,210
1334851980000000000,7,0,128,37,38,210
1334852040000000000,7,0,128,37,37,209
1334852100000000000,7,0,128,37,37,209
1334852160000000000,7,0,127,36,37,207
1334852220000000000,7,0,127,38,38,210
1334852280000000000,7,0,129,38,37,211
1334852340000000000,7,0,126,37,38,208
1334852400000000000,7,0,0,37,37,81
1334852460000000000,7,0,0,38,37,82
1334852520000000000,7,0,1,38,37,83
1334852580000000000,7,0,0,37,38,82
1334852640000000000,7,0,0,37,37,81
1334852700000000000,7,0,0,37,38,82
1334852760000000000,7,0,0,37,38,82
1334852820000000000,7,0,0,37,37,81
1334852880000000000,7,0,0,37,38,82
1334852940000000000,7,0,0,38,38,83
1334853000000000000,7,0,0,38,38,83
1334853060000000000,7,0,0,37,37,81
1334853120000000000,7,0,1,37,38,83
1334853180000000000,7,0,0,36,37,80
1334853240000000000,7,0,0,38,38,83
1334853300000000000,7,0,1,38,37,83
1334853360000000000,7,0,0,37,37,81
1334853420000000000,7,0,0,38,37,82
1334853480000000000,7,0,0,38,37,82
1334853540000000000,7,0,0,38,37,82
1334853600000000000,7,0,0,37,38,82
1334853660000000000,7,0,0,36,37,80
1334853720000000000,7,0,0,38,37,82
1334853780000000000,7,0,0,37,38,82
1334853840000000000,7,0,0,37,37,81
1334853900000000000,7,0,0,37,37,81
1334853960000000000,7,0,0,36,37,80
1334854020000000000,7,0,1,36,37,81
1334854080000000000,7,0,816,37,37,897
1334854140000000000,7,0,142,37,37,223
1334854200000000000,7,0,131,37,37,212
1334854260000000000,7,0,127,37,37,208
1334854320000000000,7,0,127,37,37,208
1334854380000000000,7,0,125,37,38,207
1334854440000000000,7,0,125,37,37,206
1334854500000000000,7,0,123,37,38,205
1334854560000000000,7,0,122,36,38,203
1334854620000000000,7,0,123,38,38,206
1334854680000000000,7,0,121,37,37,202
1334854740000000000,7,0,0,37,38,82
1334854800000000000,7,0,0,37,38,82
1334854860000000000,7,0,0,38,38,83
1334854920000000000,7,0,0,37,38,82
1334854980000000000,7,0,0,36,37,80
1334855040000000000,7,0,1,37,37,82
1334855100000000000,7,0,0,36,38,81
1334855160000000000,7,0,0,37,38,82
1334855220000000000,7,0,0,37,38,82
1334855280000000000,7,0,0,37,37,81
1334855340000000000,7,0,0,37,38,82
1334855400000000000,7,0,0,36,37,80
1334855460000000000,7,0,0,37,38,82
1334855520000000000,7,0,0,37,37,81
1334855580000000000,7,0,0,37,37,81
1334855640000000000,7,0,0,37,37,81
1334855700000000000,7,0,80,37,38,162
1334855760000000000,7,0,1,36,37,81
1334855820000000000,7,0,1,36,37,81
1334855880000000000,7,0,1,36,37,81
1334855940000000000,7,0,10,36,37,90
1334856000000000000,7,0,5,36,37,85
1334856060000000000,7,0,0,36,37,80
1334856120000000000,7,0,0,36,38,81
1334856180000000000,7,0,0,36,37,80
1334856240000000000,7,0,0,36,37,80
1334856300000000000,8,0,0,37,37,82
1334856360000000000,7,0,0,1369,37,1413
1334856420000000000,8,0,0,1631,37,1676
1334856480000000000,7,0,0,1741,37,1785
1334856540000000000,7,0,144,1766,37,1954
1334856600000000000,7,0,138,1787,37,1969
1334856660000000000,8,0,127,1759,37,1931
1334856720000000000,7,0,126,1771,37,1941
1334856780000000000,8,0,125,1782,37,1952
1334856840000000000,8,0,124,1789,37,1958
1334856900000000000,7,0,123,1789,37,1956
1334856960000000000,7,0,121,1799,37,1964
1334857020000000000,8,0,121,1806,37,1972
1334857080000000000,7,0,120,1805,37,1969
1334857140000000000,7,0,120,1814,37,1978
1334857200000000000,7,0,0,1805,37,1849
1334857260000000000,7,0,0,1811,37,1855
1334857320000000000,7,0,0,1818,37,1862
1334857380000000000,7,0,0,1829,37,1873
1334857440000000000,7,0,6,1810,37,1860
1334857500000000000,7,0,6,1834,38,1885
1334857560000000000,8,0,6,1822,37,1873
1334857620000000000,7,0,6,0,37,50
1334857680000000000,7,0,6,1,37,51
1334857740000000000,7,0,6,1,37,51
1334857800000000000,7,0,6,1,37,51
1334857860000000000,7,0,6,1,37,51
1334857920000000000,7,0,86,1,37,131
1334857980000000000,7,0,6,1,37,51
1334858040000000000,7,0,148,0,37,192
1334858100000000000,7,0,138,1,37,183
1334858160000000000,8,0,138,1,37,184
1334858220000000000,7,0,137,1,37,182
1334858280000000000,7,0,136,1,37,181
1334858340000000000,7,0,136,2,37,182
1334858400000000000,8,0,135,1,37,181
1334858460000000000,8,0,133,1,37,179
1334858520000000000,7,0,132,1,37,177
1334858580000000000,8,0,132,1,37,178
1334858640000000000,7,0,132,1,37,177
1334858700000000000,7,0,132,1,37,177
1334858760000000000,7,0,132,1,37,177
1334858820000000000,7,0,131,38,37,213
1334858880000000000,7,0,130,37,38,212
1334858940000000000,7,0,129,37,37,210
1334859000000000000,7,0,130,37,37,211
1334859060000000000,7,0,130,36,38,211
1334859120000000000,7,0,132,36,38,213
1334859180000000000,7,0,131,37,37,212
1334859240000000000,7,0,130,37,37,211
1334859300000000000,7,0,131,36,37,211
1334859360000000000,7,0,130,37,37,211
1334859420000000000,7,0,130,37,38,212
1334859480000000000,7,0,129,36,37,209
1334859540000000000,7,0,131,37,37,212
1334859600000000000,7,0,128,38,38,211
1334859660000000000,7,0,129,37,37,210
1334859720000000000,7,0,127,37,38,209
1334859780000000000,7,0,128,37,37,209
1334859840000000000,7,0,127,37,37,208
1334859900000000000,7,0,127,37,38,209
1334859960000000000,7,0,7,37,37,88
1334860020000000000,7,0,10,36,37,90
1334860080000000000,7,0,0,37,38,82
1334860140000000000,7,0,1,38,38,84
1334860200000000000,7,0,0,36,37,80
1334860260000000000,7,0,0,38,38,83
1334860320000000000,7,0,0,37,37,81
1334860380000000000,7,0,0,36,37,80
1334860440000000000,7,0,0,37,38,82
1334860500000000000,7,0,0,37,37,81
1334860560000000000,7,0,0,36,37,80
1334860620000000000,7,0,0,37,37,81
1334860680000000000,7,0,0,36,37,80
1334860740000000000,7,0,0,36,37,80
1334860800000000000,7,0,0,36,37,80
1334860860000000000,7,0,0,37,38,82
1334860920000000000,7,0,139,36,37,219
1334860980000000000,7,0,139,36,37,219
1334861040000000000,7,0,128,36,37,208
1334861100000000000,7,0,126,37,38,208
1334861160000000000,7,0,125,36,37,205
1334861220000000000,7,0,124,35,37,203
1334861280000000000,7,0,123,36,37,203
1334861340000000000,7,0,122,37,38,204
1334861400000000000,7,0,122,37,38,204
1334861460000000000,7,0,122,37,37,203
1334861520000000000,7,0,0,38,37,82
1334861580000000000,7,0,0,38,37,82
1334861640000000000,7,0,0,38,38,83
1334861700000000000,7,0,1,37,37,82
1334861760000000000,7,0,1,37,38,83
1334861820000000000,7,0,0,38,38,83
1334861880000000000,7,0,1,37,38,83
1334861940000000000,7,0,1,37,38,83
1334862000000000000,7,0,1,38,38,84
1334862060000000000,7,0,0,38,38,83
1334862120000000000,7,0,1,37,38,83
1334862180000000000,7,0,0,37,37,81
1334862240000000000,7,0,1,38,37,83
1334862300000000000,7,0,0,38,37,82
1334862360000000000,7,0,0,38,38,83
1334862420000000000,7,0,0,37,38,82
1334862480000000000,7,0,1,37,37,82
1334862540000000000,7,0,0,38,38,83
1334862600000000000,7,0,0,37,38,82
1334862660000000000,7,0,1,37,38,83
1334862720000000000,7,0,0,38,37,82
1334862780000000000,7,0,0,37,37,81
1334862840000000000,7,0,0,37,38,82
1334862900000000000,7,0,0,38,37,82
1334862960000000000,7,0,0,36,37,80
1334863020000000000,7,0,0,38,37,82
1334863080000000000,7,0,1,37,38,83
1334863140000000000,7,0,0,38,37,82
1334863200000000000,7,0,0,38,38,83
1334863260000000000,7,0,0,38,37,82
1334863320000000000,7,0,0,37,38,82
1334863380000000000,7,0,0,36,37,80
1334863440000000000,7,0,0,38,38,83
1334863500000000000,7,0,0,37,38,82
1334863560000000000,7,0,0,37,38,82
1334863620000000000,7,0,10,38,37,92
1334863680000000000,7,0,7,37,37,88
1334863740000000000,7,0,147,38,37,229
1334863800000000000,7,0,135,38,37,217
1334863860000000000,7,0,129,37,38,211
1334863920000000000,7,0,127,37,37,208
1334863980000000000,7,0,126,38,38,209
1334864040000000000,7,0,125,38,37,207
1334864100000000000,7,0,125,38,37,207
1334864160000000000,7,0,124,38,38,207
1334864220000000000,7,0,123,38,38,206
1334864280000000000,7,0,123,38,38,206
1334864340000000000,7,0,121,38,38,204
1334864400000000000,7,0,0,37,37,81
1334864460000000000,7,0,0,38,38,83
1334864520000000000,7,0,0,37,37,81
1334864580000000000,7,0,0,37,37,81
1334864640000000000,7,0,0,37,38,82
1334864700000000000,7,0,0,37,38,82
1334864760000000000,7,0,0,38,37,82
1334864820000000000,7,0,0,38,38,83
1334864880000000000,7,0,1,38,37,83
1334864940000000000,7,0,0,38,37,82
1334865000000000000,7,0,0,37,38,82
1334865060000000000,7,0,0,38,38,83
1334865120000000000,7,0,0,38,37,82
1334865180000000000,7,0,0,37,38,82
1334865240000000000,7,0,0,37,37,81
1334865300000000000,7,0,0,37,38,82
1334865360000000000,7,0,0,37,37,81
1334865420000000000,7,0,0,38,38,83
1334865480000000000,7,0,0,38,38,83
1334865540000000000,7,0,0,37,38,82
1334865600000000000,7,0,0,38,38,83
1334865660000000000,7,0,0,37,37,81
1334865720000000000,7,0,0,38,38,83
1334865780000000000,7,0,1,37,37,82
1334865840000000000,7,0,0,38,38,83
1334865900000000000,7,0,0,38,38,83
1334865960000000000,7,0,0,38,37,82
1334866020000000000,7,0,0,37,37,81
1334866080000000000,7,0,0,37,38,82
1334866140000000000,7,0,0,38,38,83
1334866200000000000,7,0,0,38,37,82
1334866260000000000,7,0,0,37,38,82
1334866320000000000,7,0,0,37,37,81
1334866380000000000,7,0,0,38,37,82
1334866440000000000,7,0,0,38,37,82
1334866500000000000,7,0,1,37,37,82
1334866560000000000,7,0,0,38,37,82
1334866620000000000,7,0,0,38,38,83
1334866680000000000,7,0,145,1188,37,1377
1334866740000000000,7,0,133,1599,37,1776
1334866800000000000,7,0,127,1729,37,1900
1334866860000000000,338,0,127,1767,37,2269
1334866920000000000,338,0,126,1793,241,2498
1334866980000000000,342,0,125,1805,285,2557
1334867040000000000,330,0,123,1783,247,2483
1334867100000000000,331,0,123,1792,247,2493
1334867160000000000,329,0,122,1799,230,2480
1334867220000000000,329,0,121,1810,294,2554
1334867280000000000,330,0,10,1811,250,2401
1334867340000000000,330,0,7,1814,247,2398
1334867400000000000,331,0,0,1819,274,2424
1334867460000000000,330,0,0,1822,210,2362
1334867520000000000,330,0,0,1827,297,2454
1334867580000000000,330,0,0,1827,255,2412
1334867640000000000,330,0,0,1830,249,2409
1334867700000000000,332,0,0,1,260,593
1334867760000000000,332,0,0,1,258,591
1334867820000000000,332,0,0,1,255,588
1334867880000000000,333,0,0,0,268,601
1334867940000000000,334,0,0,0,231,565
1334868000000000000,334,0,0,0,241,575
1334868060000000000,332,0,0,1,251,584
1334868120000000000,333,0,10,1,254,598
1334868180000000000,333,0,7,1,242,583
1334868240000000000,333,0,7,0,236,576
1334868300000000000,333,0,7,0,248,588
1334868360000000000,333,0,7,1,218,559
1334868420000000000,331,0,7,0,218,556
1334868480000000000,331,0,6,1,253,591
1334868540000000000,330,0,154,1,215,700
1334868600000000000,331,0,140,0,215,686
1334868660000000000,332,0,135,1,223,691
1334868720000000000,329,0,134,42,213,718
1334868780000000000,328,0,132,37,212,709
1334868840000000000,328,0,131,37,212,708
1334868900000000000,329,0,132,36,210,707
1334868960000000000,331,0,130,37,215,713
1334869020000000000,329,0,130,36,214,709
1334869080000000000,330,0,131,36,238,735
1334869140000000000,329,0,129,37,247,742
1334869200000000000,331,0,129,36,254,750
1334869260000000000,329,0,128,36,228,721
1334869320000000000,331,0,130,36,217,714
1334869380000000000,331,0,128,36,219,714
1334869440000000000,330,0,127,37,256,750
1334869500000000000,332,0,127,36,210,705
1334869560000000000,330,0,127,37,212,706
1334869620000000000,332,0,127,36,216,711
1334869680000000000,333,0,127,36,210,706
1334869740000000000,332,0,128,38,210,708
1334869800000000000,333,0,129,36,223,721
1334869860000000000,335,0,0,36,215,586
1334869920000000000,334,0,0,37,229,600
1334869980000000000,334,0,0,36,227,597
1334870040000000000,335,0,0,37,261,633
1334870100000000000,334,0,0,36,213,583
1334870160000000000,334,0,0,37,207,578
1334870220000000000,333,0,0,38,214,585
1334870280000000000,334,0,0,36,225,595
1334870340000000000,334,0,0,38,227,599
1334870400000000000,333,0,0,37,333,703
1334870460000000000,336,0,0,38,223,597
1334870520000000000,335,0,0,36,219,590
1334870580000000000,335,0,0,37,396,768
1334870640000000000,335,0,0,36,224,595
1334870700000000000,336,0,0,36,212,584
1334870760000000000,335,0,0,37,220,592
1334870820000000000,334,0,0,37,366,737
1334870880000000000,334,0,0,37,222,593
1334870940000000000,333,0,0,37,213,583
1334871000000000000,333,0,0,38,217,588
1334871060000000000,334,0,0,37,215,586
1334871120000000000,334,0,0,37,313,684
1334871180000000000,337,0,0,36,37,410
1334871240000000000,7,0,0,38,37,82
1334871300000000000,7,0,0,37,37,81
1334871360000000000,7,0,0,36,36,79
1334871420000000000,7,0,0,37,36,80
1334871480000000000,7,0,0,37,37,81
1334871540000000000,7,0,148,36,36,227
1334871600000000000,7,0,134,38,36,215
1334871660000000000,7,0,127,37,37,208
1334871720000000000,7,0,128,37,37,209
1334871780000000000,7,0,125,36,36,204
1334871840000000000,7,0,126,37,37,207
1334871900000000000,7,0,123,37,38,205
1334871960000000000,7,0,123,38,37,205
1334872020000000000,7,0,122,37,37,203
1334872080000000000,7,0,123,37,37,204
1334872140000000000,7,0,121,37,37,202
1334872200000000000,7,0,0,36,37,80
1334872260000000000,7,0,1,37,37,82
1334872320000000000,7,0,1,38,38,84
1334872380000000000,7,0,0,37,38,82
1334872440000000000,7,0,0,37,37,81
1334872500000000000,7,0,1,36,37,81
1334872560000000000,7,0,0,37,38,82
1334872620000000000,7,0,0,38,37,82
1334872680000000000,7,0,0,36,38,81
1334872740000000000,7,0,0,38,37,82
1334872800000000000,7,0,0,36,37,80
1334872860000000000,7,0,0,37,37,81
1334872920000000000,7,0,0,36,37,80
1334872980000000000,7,0,0,38,38,83
1334873040000000000,7,0,0,37,38,82
1334873100000000000,7,0,1,36,37,81
1334873160000000000,7,0,0,37,37,81
1334873220000000000,7,0,0,38,37,82
1334873280000000000,7,0,0,38,38,83
1334873340000000000,7,0,0,37,37,81
1334873400000000000,7,0,10,37,37,91
1334873460000000000,7,0,7,37,38,89
1334873520000000000,7,0,0,37,37,81
1334873580000000000,7,0,0,37,37,81
1334873640000000000,7,0,1,36,38,82
1334873700000000000,7,0,0,37,37,81
1334873760000000000,7,0,0,37,37,81
1334873820000000000,7,0,0,1195,38,1240
1334873880000000000,7,0,0,1612,38,1657
1334873940000000000,7,0,0,1728,38,1773
1334874000000000000,7,0,0,1778,38,1823
1334874060000000000,7,0,0,1802,38,1847
1334874120000000000,7,0,144,1774,37,1962
1334874180000000000,7,0,131,1789,37,1964
1334874240000000000,7,0,127,1801,37,1972
1334874300000000000,7,0,127,1807,38,1979
1334874360000000000,7,0,125,1811,38,1981
1334874420000000000,7,0,125,1817,38,1987
1334874480000000000,7,0,123,1818,37,1985
1334874540000000000,7,0,124,1824,38,1993
1334874600000000000,7,0,122,1834,38,2001
1334874660000000000,7,0,122,1833,37,1999
1334874720000000000,7,0,0,1835,37,1879
1334874780000000000,7,0,0,2,38,47
1334874840000000000,7,0,0,1,38,46
1334874900000000000,7,0,1,1,37,46
1334874960000000000,7,0,0,1,37,45
1334875020000000000,7,0,0,1,37,45
1334875080000000000,7,0,0,1,37,45
1334875140000000000,7,0,0,1,38,46
1334875200000000000,7,0,0,1,37,45
1334875260000000000,7,0,1,1,37,46
1334875320000000000,7,0,0,0,38,45
1334875380000000000,7,0,0,1,38,46
1334875440000000000,7,0,1,1,37,46
1334875500000000000,7,0,0,1,37,45
1334875560000000000,7,0,0,1,37,45
1334875620000000000,7,0,0,1,37,45
1334875680000000000,7,0,0,1,38,46
1334875740000000000,7,0,0,1,38,46
1334875800000000000,7,0,0,1,37,45
1334875860000000000,7,0,0,1,37,45
1334875920000000000,7,0,0,0,38,45
1334875980000000000,7,0,0,1,37,45
1334876040000000000,7,0,0,39,37,83
1334876100000000000,7,0,0,37,37,81
1334876160000000000,7,0,0,38,37,82
1334876220000000000,7,0,0,38,38,83
1334876280000000000,7,0,0,36,37,80
1334876340000000000,7,0,0,37,38,82
1334876400000000000,7,0,1,38,37,83
1334876460000000000,7,0,0,37,37,81
1334876520000000000,7,0,1,37,37,82
1334876580000000000,7,0,0,37,38,82
1334876640000000000,7,0,1,38,37,83
1334876700000000000,7,0,0,37,38,82
1334876760000000000,7,0,0,37,37,81
1334876820000000000,7,0,0,36,38,81
1334876880000000000,7,0,0,36,38,81
1334876940000000000,7,0,0,38,38,83
1334877000000000000,7,0,0,37,37,81
1334877060000000000,7,0,150,36,38,231
1334877120000000000,7,0,138,37,37,219
1334877180000000000,7,0,130,36,37,210
1334877240000000000,7,0,128,36,38,209
1334877300000000000,7,0,127,37,37,208
1334877360000000000,7,0,127,36,38,208
1334877420000000000,7,0,124,37,37,205
1334877480000000000,7,0,123,36,37,203
1334877540000000000,329,0,122,38,37,526
1334877600000000000,328,0,122,36,233,719
1334877660000000000,329,0,121,37,218,705
1334877720000000000,332,0,0,38,236,606
1334877780000000000,331,0,0,36,239,606
1334877840000000000,331,0,0,36,251,618
1334877900000000000,333,0,0,36,307,676
1334877960000000000,331,0,0,37,258,626
1334878020000000000,333,0,0,36,242,611
1334878080000000000,331,0,0,36,244,611
1334878140000000000,331,0,0,37,210,578
1334878200000000000,334,0,0,36,227,597
1334878260000000000,334,0,7,37,222,600
1334878320000000000,334,0,7,37,227,605
1334878380000000000,333,0,7,36,224,600
1334878440000000000,329,0,6,36,279,650
1334878500000000000,330,0,6,36,244,616
1334878560000000000,332,0,6,36,245,619
1334878620000000000,329,0,6,36,265,636
1334878680000000000,331,0,7,38,251,627
1334878740000000000,330,0,7,37,248,622
1334878800000000000,328,0,142,37,266,773
1334878860000000000,331,0,143,36,224,734
1334878920000000000,328,0,136,36,227,727
1334878980000000000,329,0,135,36,186,686
1334879040000000000,330,0,133,36,130,629
1334879100000000000,328,0,132,36,130,626
1334879160000000000,329,0,132,37,222,720
1334879220000000000,329,0,132,36,256,753
1334879280000000000,326,0,130,36,234,726
1334879340000000000,328,0,130,36,223,717
1334879400000000000,326,0,129,36,237,728
1334879460000000000,329,0,131,36,238,734
1334879520000000000,331,0,128,36,295,790
1334879580000000000,326,0,128,35,245,734
1334879640000000000,328,0,129,36,252,745
1334879700000000000,326,0,127,37,241,731
1334879760000000000,328,0,127,36,259,750
1334879820000000000,328,0,127,36,242,733
1334879880000000000,329,0,127,36,329,821
1334879940000000000,333,0,127,36,403,899
1334880000000000000,332,0,125,37,404,898
1334880060000000000,333,0,123,36,257,749
1334880120000000000,331,0,121,36,228,716
1334880180000000000,333,0,0,36,312,681
1334880240000000000,331,0,0,37,266,634
1334880300000000000,331,0,0,36,243,610
1334880360000000000,329,0,0,36,267,632
1334880420000000000,330,0,0,38,274,642
1334880480000000000,329,0,0,36,261,626
1334880540000000000,329,0,0,1508,248,2085
1334880600000000000,327,0,0,1659,264,2250
1334880660000000000,324,0,0,1738,364,2426
1334880720000000000,327,0,0,1775,293,2395
1334880780000000000,327,0,0,1798,254,2379
1334880840000000000,329,0,0,1763,261,2353
1334880900000000000,328,0,0,1776,237,2341
1334880960000000000,329,0,0,1793,261,2383
1334881020000000000,329,0,0,1792,273,2394
1334881080000000000,329,0,0,1798,257,2384
1334881140000000000,329,0,0,1799,271,2399
1334881200000000000,327,0,0,1806,264,2397
1334881260000000000,329,0,0,1815,252,2396
1334881320000000000,328,0,0,1810,247,2385
1334881380000000000,330,0,0,1819,190,2339
1334881440000000000,331,0,0,1819,216,2366
1334881500000000000,332,0,0,1826,207,2365
1334881560000000000,332,0,0,1823,220,2375
1334881620000000000,331,0,0,1,223,555
1334881680000000000,7,0,0,0,48,55
1334881740000000000,7,0,0,1,48,56
1334881800000000000,7,0,0,1,48,56
1334881860000000000,7,0,0,1,48,56
1334881920000000000,7,0,0,1,48,56
1334881980000000000,7,0,0,1,48,56
1334882040000000000,7,0,0,1,48,56
1334882100000000000,7,0,0,1,48,56
1334882160000000000,7,0,147,1,47,202
1334882220000000000,7,0,137,0,48,192
1334882280000000000,7,0,127,1,48,183
1334882340000000000,7,0,127,1,49,184
1334882400000000000,7,0,125,1,48,181
1334882460000000000,7,0,125,37,48,217
1334882520000000000,7,0,124,37,48,216
1334882580000000000,7,0,123,38,48,216
1334882640000000000,7,0,122,37,47,213
1334882700000000000,7,0,122,36,48,213
1334882760000000000,7,0,121,36,48,212
1334882820000000000,7,0,0,36,48,91
1334882880000000000,7,0,0,37,48,92
1334882940000000000,7,0,0,37,48,92
1334883000000000000,7,0,0,36,48,91
1334883060000000000,7,0,0,37,48,92
1334883120000000000,7,0,0,37,48,92
1334883180000000000,7,0,0,37,47,91
1334883240000000000,7,0,0,36,48,91
1334883300000000000,7,0,0,36,48,91
1334883360000000000,7,0,0,37,48,92
1334883420000000000,7,0,0,37,47,91
1334883480000000000,7,0,0,35,48,90
1334883540000000000,7,0,0,37,49,93
1334883600000000000,7,0,10,36,48,101
1334883660000000000,7,0,0,36,48,91
1334883720000000000,7,0,0,37,48,92
1334883780000000000,7,0,0,36,48,91
1334883840000000000,7,0,0,38,37,82
1334883900000000000,7,0,0,36,37,80
1334883960000000000,7,0,0,37,38,82
1334884020000000000,7,0,0,36,38,81
1334884080000000000,7,0,0,38,37,82
1334884140000000000,7,0,0,36,37,80
1334884200000000000,7,0,0,37,37,81
1334884260000000000,7,0,0,37,38,82
1334884320000000000,7,0,0,37,38,82
1334884380000000000,7,0,1,37,38,83
1334884440000000000,7,0,1,37,37,82
1334884500000000000,7,0,0,37,37,81
1334884560000000000,7,0,0,37,37,81
1334884620000000000,7,0,1,37,37,82
1334884680000000000,7,0,0,36,37,80
1334884740000000000,7,0,143,37,37,224
1334884800000000000,7,0,129,36,37,209
1334884860000000000,7,0,127,37,38,209
1334884920000000000,7,0,127,37,37,208
1334884980000000000,7,0,125,37,37,206
1334885040000000000,7,0,124,36,37,204
1334885100000000000,7,0,123,37,37,204
1334885160000000000,7,0,122,37,37,203
1334885220000000000,7,0,122,38,37,204
1334885280000000000,7,0,120,36,37,200
1334885340000000000,7,0,0,36,37,80
1334885400000000000,7,0,0,37,37,81
1334885460000000000,7,0,0,37,37,81
1334885520000000000,7,0,0,37,37,81
1334885580000000000,7,0,0,37,37,81
1334885640000000000,7,0,0,36,37,80
1334885700000000000,7,0,1,37,38,83
1334885760000000000,7,0,0,37,37,81
1334885820000000000,7,0,0,1438,38,1483
1334885880000000000,7,0,0,1630,37,1674
1334885940000000000,7,0,0,1729,37,1773
1334886000000000000,7,0,0,1771,38,1816
1334886060000000000,7,0,0,1792,38,1837
1334886120000000000,7,0,0,1777,37,1821
1334886180000000000,7,0,0,1784,37,1828
1334886240000000000,7,0,0,1795,38,1840
1334886300000000000,7,0,0,1807,37,1851
1334886360000000000,7,0,0,1811,37,1855
1334886420000000000,7,0,0,1816,38,1861
1334886480000000000,7,0,0,1821,38,1866
1334886540000000000,7,0,0,1817,37,1861
1334886600000000000,7,0,0,1825,38,1870
1334886660000000000,7,0,0,1825,37,1869
1334886720000000000,7,0,0,1829,37,1873
1334886780000000000,7,0,0,1830,37,1874
1334886840000000000,7,0,0,1832,37,1876
1334886900000000000,7,0,0,1832,38,1877
1334886960000000000,7,0,1,53,37,98
1334887020000000000,7,0,1,1,37,46
1334887080000000000,7,0,0,1,37,45
1334887140000000000,7,0,0,1,37,45
1334887200000000000,7,0,10,1,37,55
1334887260000000000,7,0,10,1,38,56
1334887320000000000,7,0,1,1,38,47
1334887380000000000,7,0,0,1,38,46
1334887440000000000,7,0,1,1,38,47
1334887500000000000,7,0,143,1,39,190
1334887560000000000,7,0,132,1,39,179
1334887620000000000,7,0,128,1,39,175
1334887680000000000,7,0,127,1,38,173
1334887740000000000,7,0,126,1,38,172
1334887800000000000,7,0,126,1,38,172
1334887860000000000,7,0,125,1,39,172
1334887920000000000,7,0,123,1,38,169
1334887980000000000,7,0,122,39,38,206
1334888040000000000,7,0,121,37,39,204
1334888100000000000,7,0,0,37,38,82
1334888160000000000,7,0,0,36,39,82
1334888220000000000,7,0,0,38,38,83
1334888280000000000,7,0,0,37,38,82
1334888340000000000,7,0,0,37,38,82
1334888400000000000,7,0,0,36,38,81
1334888460000000000,7,0,0,36,38,81
1334888520000000000,7,0,0,37,38,82
1334888580000000000,7,0,0,36,38,81
1334888640000000000,7,0,0,37,38,82
1334888700000000000,7,0,0,37,39,83
1334888760000000000,7,0,0,38,39,84
1334888820000000000,7,0,0,37,39,83
1334888880000000000,7,0,0,36,38,81
1334888940000000000,7,0,7,37,38,89
1334889000000000000,7,0,7,37,38,89
1334889060000000000,7,0,7,37,39,90
1334889120000000000,7,0,7,38,39,91
1334889180000000000,7,0,7,37,38,89
1334889240000000000,7,0,7,36,38,88
1334889300000000000,7,0,7,37,39,90
1334889360000000000,7,0,7,36,39,89
1334889420000000000,7,0,150,37,39,233
1334889480000000000,7,0,139,36,38,220
1334889540000000000,7,0,136,37,39,219
1334889600000000000,7,0,134,36,39,216
1334889660000000000,7,0,134,37,39,217
1334889720000000000,7,0,132,37,38,214
1334889780000000000,7,0,132,36,38,213
1334889840000000000,7,0,133,38,38,216
1334889900000000000,7,0,132,37,38,214
1334889960000000000,7,0,132,37,38,214
1334890020000000000,7,0,131,36,38,212
1334890080000000000,7,0,130,38,38,213
1334890140000000000,7,0,129,36,39,211
1334890200000000000,7,0,129,35,39,210
1334890260000000000,7,0,129,36,39,211
1334890320000000000,7,0,130,35,39,211
1334890380000000000,7,0,128,36,39,210
1334890440000000000,7,0,128,37,38,210
1334890500000000000,7,0,127,36,39,209
1334890560000000000,7,0,127,36,39,209
1334890620000000000,7,0,127,36,38,208
1334890680000000000,7,0,125,38,38,208
1334890740000000000,7,0,122,37,39,205
1334890800000000000,7,0,0,36,39,82
1334890860000000000,7,0,0,37,37,81
1334890920000000000,7,0,0,36,37,80
1334890980000000000,7,0,0,36,38,81
1334891040000000000,7,0,0,38,38,83
1334891100000000000,7,0,0,38,39,84
1334891160000000000,7,0,0,38,38,83
1334891220000000000,7,0,0,37,38,82
1334891280000000000,7,0,1,38,38,84
1334891340000000000,7,0,0,38,38,83
1334891400000000000,7,0,0,36,38,81
1334891460000000000,7,0,0,37,38,82
1334891520000000000,7,0,1,36,38,82
1334891580000000000,7,0,0,38,38,83
1334891640000000000,7,0,0,36,37,80
1334891700000000000,7,0,0,36,38,81
1334891760000000000,7,0,0,36,38,81
1334891820000000000,7,0,0,36,38,81
1334891880000000000,7,0,0,36,38,81
1334891940000000000,7,0,0,36,38,81
1334892000000000000,7,0,0,36,38,81
1334892060000000000,7,0,0,36,38,81
1334892120000000000,7,0,0,38,38,83
1334892180000000000,7,0,0,37,38,82
1334892240000000000,7,0,0,36,38,81
1334892300000000000,7,0,0,36,38,81
1334892360000000000,7,0,0,36,38,81
1334892420000000000,7,0,0,37,38,82
1334892480000000000,7,0,0,37,38,82
1334892540000000000,7,0,0,38,38,83
1334892600000000000,7,0,0,37,38,82
1334892660000000000,7,0,0,37,37,81
1334892720000000000,7,0,0,36,37,80
1334892780000000000,7,0,147,36,38,228
1334892840000000000,7,0,136,37,37,217
1334892900000000000,7,0,127,36,38,208
1334892960000000000,7,0,126,36,38,207
1334893020000000000,7,0,125,37,38,207
1334893080000000000,7,0,126,36,38,207
1334893140000000000,7,0,123,36,38,204
1334893200000000000,7,0,123,37,38,205
1334893260000000000,7,0,122,37,37,203
1334893320000000000,7,0,121,37,38,203
1334893380000000000,7,0,121,1488,38,1654
1334893440000000000,7,0,0,1646,38,1691
1334893500000000000,7,0,0,1725,38,1770
1334893560000000000,7,0,0,1776,38,1821
1334893620000000000,7,0,0,1790,38,1835
1334893680000000000,7,0,0,1774,38,1819
1334893740000000000,7,0,0,1787,37,1831
1334893800000000000,7,0,1,1789,38,1835
1334893860000000000,7,0,0,1801,38,1846
1334893920000000000,7,0,0,1800,37,1844
1334893980000000000,7,0,0,1813,38,1858
1334894040000000000,7,0,0,1810,39,1856
1334894100000000000,7,0,1,1814,38,1860
1334894160000000000,7,0,0,1818,38,1863
1334894220000000000,7,0,0,1817,38,1862
1334894280000000000,7,0,10,1821,38,1876
1334894340000000000,7,0,0,1826,38,1871
1334894400000000000,7,0,0,1829,38,1874
1334894460000000000,7,0,0,1831,38,1876
1334894520000000000,7,0,0,1831,38,1876
1334894580000000000,7,0,0,1,38,46
1334894640000000000,7,0,0,0,38,45
1334894700000000000,7,0,0,1,38,46
1334894760000000000,7,0,0,1,38,46
1334894820000000000,7,0,0,1,38,46
1334894880000000000,7,0,0,1,38,46
1334894940000000000,7,0,0,1,38,46
1334895000000000000,7,0,0,1,38,46
1334895060000000000,7,0,0,1,37,45
1334895120000000000,7,0,0,1,38,46
1334895180000000000,7,0,0,1,38,46
1334895240000000000,7,0,0,1,38,46
1334895300000000000,7,0,0,1,38,46
1334895360000000000,7,0,144,1,38,190
1334895420000000000,7,0,132,42,37,218
1334895480000000000,7,0,129,38,38,212
1334895540000000000,7,0,126,38,39,210
1334895600000000000,7,0,126,37,38,208
1334895660000000000,7,0,125,37,38,207
1334895720000000000,7,0,124,38,38,207
1334895780000000000,7,0,123,38,38,206
1334895840000000000,7,0,124,37,38,206
1334895900000000000,7,0,122,38,38,205
1334895960000000000,7,0,0,38,38,83
1334896020000000000,7,0,0,37,39,83
1334896080000000000,7,0,0,36,38,81
1334896140000000000,7,0,0,37,38,82
1334896200000000000,7,0,0,37,38,82
1334896260000000000,7,0,0,38,38,83
1334896320000000000,7,0,0,36,38,81
1334896380000000000,7,0,0,38,38,83
1334896440000000000,7,0,0,37,38,82
1334896500000000000,7,0,1,37,38,83
1334896560000000000,7,0,0,37,38,82
1334896620000000000,7,0,0,37,39,83
1334896680000000000,7,0,0,37,38,82
1334896740000000000,7,0,0,36,38,81
1334896800000000000,7,0,0,38,38,83
1334896860000000000,337,0,0,37,143,517
1334896920000000000,333,0,0,38,217,588
1334896980000000000,333,0,0,37,202,572
1334897040000000000,333,0,0,37,318,688
1334897100000000000,334,0,0,37,250,621
1334897160000000000,336,0,0,36,220,592
1334897220000000000,333,0,0,37,226,596
1334897280000000000,331,0,0,37,223,591
1334897340000000000,333,0,0,37,233,603
1334897400000000000,334,0,0,37,192,563
1334897460000000000,335,0,0,37,325,697
1334897520000000000,335,0,0,38,240,613
1334897580000000000,335,0,0,37,238,610
1334897640000000000,335,0,0,37,390,762
1334897700000000000,336,0,0,37,318,691
1334897760000000000,337,0,0,36,222,595
1334897820000000000,335,0,0,36,385,756
1334897880000000000,336,0,10,37,207,590
1334897940000000000,338,0,10,37,219,604
1334898000000000000,338,0,0,37,381,756
1334898060000000000,333,0,0,37,215,585
1334898120000000000,329,0,149,36,370,884
1334898180000000000,329,0,139,36,220,724
1334898240000000000,329,0,128,36,259,752
1334898300000000000,328,0,205,37,236,806
1334898360000000000,328,0,129,36,232,725
1334898420000000000,329,0,131,36,227,723
1334898480000000000,329,0,130,36,243,738
1334898540000000000,328,0,131,37,211,707
1334898600000000000,327,0,130,36,206,699
1334898660000000000,326,0,129,1545,252,2252
1334898720000000000,326,0,128,1672,364,2490
1334898780000000000,327,0,128,1743,221,2419
1334898840000000000,327,0,128,1782,373,2610
1334898900000000000,325,0,127,1800,250,2502
1334898960000000000,325,0,127,1777,222,2451
1334899020000000000,324,0,127,1791,261,2503
1334899080000000000,325,0,127,1795,252,2499
1334899140000000000,327,0,126,1805,226,2484
1334899200000000000,327,0,127,1810,312,2576
1334899260000000000,327,0,126,1814,227,2494
1334899320000000000,328,0,126,1825,235,2514
1334899380000000000,329,0,6,1826,223,2384
1334899440000000000,328,0,7,1829,254,2418
1334899500000000000,329,0,6,1831,326,2492
1334899560000000000,327,0,6,1833,257,2423
1334899620000000000,329,0,7,1838,254,2428
1334899680000000000,327,0,6,1835,238,2406
1334899740000000000,330,0,7,1,231,569
1334899800000000000,329,0,6,0,238,573
1334899860000000000,329,0,7,1,245,582
1334899920000000000,329,0,6,0,212,547
1334899980000000000,328,0,148,0,234,710
1334900040000000000,331,0,137,1,212,681
1334900100000000000,329,0,134,0,224,687
1334900160000000000,328,0,133,0,220,681
1334900220000000000,332,0,133,1,208,674
1334900280000000000,332,0,134,0,226,692
1334900340000000000,331,0,129,1,210,671
1334900400000000000,331,0,127,0,206,664
1334900460000000000,333,0,126,0,224,683
1334900520000000000,333,0,124,0,228,685
1334900580000000000,334,0,122,0,316,772
1334900640000000000,332,0,122,0,330,784
1334900700000000000,331,0,121,1,256,709
1334900760000000000,331,0,121,38,235,725
1334900820000000000,333,0,0,38,227,598
1334900880000000000,330,0,0,37,231,598
1334900940000000000,333,0,0,37,231,601
1334901000000000000,333,0,0,38,245,616
1334901060000000000,334,0,0,38,240,612
1334901120000000000,334,0,0,36,312,682
1334901180000000000,336,0,0,36,222,594
1334901240000000000,330,0,0,37,387,754
1334901300000000000,330,0,0,37,228,595
1334901360000000000,330,0,0,37,306,673
1334901420000000000,331,0,0,37,238,606
1334901480000000000,330,0,0,36,220,586
1334901540000000000,330,0,0,37,221,588
1334901600000000000,329,0,0,36,235,600
1334901660000000000,330,0,0,38,244,612
1334901720000000000,330,0,0,36,244,610
1334901780000000000,330,0,0,36,246,612
1334901840000000000,330,0,0,36,234,600
1334901900000000000,331,0,0,36,223,590
1334901960000000000,331,0,0,37,233,601
1334902020000000000,330,0,0,36,241,607
1334902080000000000,331,0,0,37,223,591
1334902140000000000,333,0,0,37,236,606
1334902200000000000,334,0,0,37,316,687
1334902260000000000,334,0,0,37,316,687
1334902320000000000,334,0,0,37,375,746
1334902380000000000,335,0,0,37,298,670
1334902440000000000,335,0,0,38,245,618
1334902500000000000,335,0,0,37,255,627
1334902560000000000,333,0,0,37,256,626
1334902620000000000,333,0,0,37,270,640
1334902680000000000,333,0,0,36,37,406
1334902740000000000,7,0,0,37,37,81
1334902800000000000,7,0,0,1452,37,1496
1334902860000000000,7,0,0,1656,37,1700
1334902920000000000,7,0,0,1749,38,1794
1334902980000000000,7,0,141,1785,38,1971
1334903040000000000,7,0,130,1803,37,1977
1334903100000000000,7,0,127,1778,38,1950
1334903160000000000,7,0,127,1798,38,1970
1334903220000000000,7,0,126,1805,38,1976
1334903280000000000,7,0,124,1814,38,1983
1334903340000000000,7,0,123,1823,38,1991
1334903400000000000,7,0,123,1825,38,1993
1334903460000000000,7,0,122,1831,38,1998
1334903520000000000,7,0,121,1832,38,1998
1334903580000000000,7,0,120,1834,38,1999
1334903640000000000,7,0,0,1840,38,1885
1334903700000000000,7,0,0,1842,37,1886
1334903760000000000,7,0,0,1845,38,1890
1334903820000000000,7,0,0,1847,38,1892
1334903880000000000,7,0,10,1,38,56
1334903940000000000,7,0,7,1,38,53
1334904000000000000,7,0,0,1,38,46
1334904060000000000,7,0,0,1,39,47
1334904120000000000,7,0,0,1,38,46
1334904180000000000,7,0,0,1,38,46
1334904240000000000,7,0,0,1,38,46
1334904300000000000,7,0,0,0,38,45
1334904360000000000,7,0,0,1,38,46
1334904420000000000,7,0,0,1,38,46
1334904480000000000,7,0,0,1,38,46
1334904540000000000,7,0,0,1,38,46
1334904600000000000,7,0,0,1,38,46
1334904660000000000,7,0,0,1,38,46
1334904720000000000,7,0,0,1,37,45
1334904780000000000,7,0,0,1,38,46
1334904840000000000,7,0,0,39,38,84
1334904900000000000,7,0,1,39,38,85
1334904960000000000,7,0,0,38,38,83
1334905020000000000,7,0,0,38,38,83
1334905080000000000,7,0,0,38,38,83
1334905140000000000,7,0,0,38,38,83
1334905200000000000,7,0,0,37,38,82
1334905260000000000,7,0,0,38,38,83
1334905320000000000,7,0,0,38,37,82
1334905380000000000,7,0,0,38,38,83
1334905440000000000,7,0,0,38,38,83
1334905500000000000,7,0,0,36,38,81
1334905560000000000,7,0,0,38,39,84
1334905620000000000,7,0,143,37,38,225
1334905680000000000,7,0,130,37,38,212
1334905740000000000,7,0,127,37,38,209
1334905800000000000,7,0,126,38,38,209
1334905860000000000,7,0,126,37,38,208
1334905920000000000,7,0,125,38,38,208
1334905980000000000,7,0,124,37,38,206
1334906040000000000,7,0,123,38,38,206
1334906100000000000,7,0,122,37,38,204
1334906160000000000,7,0,122,38,38,205
1334906220000000000,7,0,0,38,38,83
1334906280000000000,7,0,1,38,38,84
1334906340000000000,7,0,0,38,38,83
1334906400000000000,7,0,0,38,39,84
1334906460000000000,7,0,0,38,38,83
1334906520000000000,7,0,1,38,38,84
1334906580000000000,7,0,1,38,38,84
1334906640000000000,7,0,0,38,37,82
1334906700000000000,7,0,1,37,38,83
1334906760000000000,7,0,0,38,38,83
1334906820000000000,7,0,0,38,38,83
1334906880000000000,7,0,1,38,38,84
1334906940000000000,7,0,0,37,39,83
1334907000000000000,7,0,0,37,39,83
1334907060000000000,7,0,0,38,37,82
1334907120000000000,7,0,1,37,38,83
1334907180000000000,7,0,0,38,38,83
1334907240000000000,7,0,0,38,38,83
1334907300000000000,7,0,0,37,39,83
1334907360000000000,7,0,0,38,38,83
1334907420000000000,7,0,0,38,38,83
1334907480000000000,7,0,0,38,38,83
1334907540000000000,7,0,7,38,38,90
1334907600000000000,7,0,1,38,39,85
1334907660000000000,7,0,0,37,38,82
1334907720000000000,7,0,1,37,38,83
1334907780000000000,7,0,0,984,38,1029
1334907840000000000,7,0,0,1581,38,1626
1334907900000000000,7,0,0,1712,39,1758
1334907960000000000,7,0,1,1767,38,1813
1334908020000000000,7,0,0,1794,38,1839
1334908080000000000,7,0,0,1816,39,1862
1334908140000000000,7,0,148,1789,38,1982
1334908200000000000,7,0,135,1799,38,1979
1334908260000000000,7,0,129,1811,38,1985
1334908320000000000,7,0,127,1815,38,1987
1334908380000000000,7,0,127,1822,38,1994
1334908440000000000,7,0,126,1825,38,1996
1334908500000000000,7,0,125,1829,39,2000
1334908560000000000,7,0,127,1834,38,2006
1334908620000000000,7,0,127,1837,38,2009
1334908680000000000,8,0,128,1840,38,2014
1334908740000000000,7,0,127,1840,38,2012
1334908800000000000,7,0,127,1845,38,2017
1334908860000000000,7,0,8,1848,38,1901
1334908920000000000,7,0,7,1850,38,1902
1334908980000000000,7,0,7,1851,38,1903
1334909040000000000,7,0,7,1851,38,1903
1334909100000000000,7,0,7,1,38,53
1334909160000000000,7,0,7,1,39,54
1334909220000000000,7,0,7,1,38,53
1334909280000000000,7,0,7,1,38,53
1334909340000000000,7,0,7,1,38,53
1334909400000000000,7,0,7,1,38,53
1334909460000000000,7,0,156,1,38,202
1334909520000000000,7,0,142,1,39,189
1334909580000000000,7,0,137,0,38,182
1334909640000000000,7,0,136,1,38,182
1334909700000000000,7,0,134,1,38,180
1334909760000000000,7,0,133,1,38,179
1334909820000000000,7,0,133,1,38,179
1334909880000000000,7,0,132,1,37,177
1334909940000000000,7,0,132,1,38,178
1334910000000000000,8,0,131,1,37,177
1334910060000000000,7,0,131,41,38,217
1334910120000000000,7,0,130,39,38,214
1334910180000000000,7,0,130,38,38,213
1334910240000000000,7,0,132,39,38,216
1334910300000000000,7,0,127,38,38,210
1334910360000000000,7,0,125,38,38,208
1334910420000000000,7,0,124,37,38,206
1334910480000000000,7,0,122,38,38,205
1334910540000000000,7,0,122,37,38,204
1334910600000000000,7,0,0,37,38,82
1334910660000000000,7,0,0,38,38,83
1334910720000000000,7,0,0,39,38,84
1334910780000000000,7,0,0,37,38,82
1334910840000000000,7,0,0,38,38,83
1334910900000000000,7,0,0,38,39,84
1334910960000000000,7,0,0,37,38,82
1334911020000000000,7,0,0,38,38,83
1334911080000000000,7,0,0,39,38,84
1334911140000000000,7,0,0,38,38,83
1334911200000000000,7,0,0,38,39,84
1334911260000000000,7,0,0,37,39,83
1334911320000000000,7,0,0,38,38,83
1334911380000000000,7,0,0,38,38,83
1334911440000000000,7,0,0,38,38,83
1334911500000000000,7,0,0,38,38,83
1334911560000000000,7,0,0,37,38,82
1334911620000000000,7,0,0,38,38,83
1334911680000000000,7,0,0,37,37,81
1334911740000000000,7,0,0,38,38,83
1334911800000000000,7,0,0,37,38,82
1334911860000000000,7,0,0,38,38,83
1334911920000000000,7,0,0,38,37,82
1334911980000000000,7,0,0,38,38,83
1334912040000000000,7,0,0,38,38,83
1334912100000000000,7,0,1,37,38,83
1334912160000000000,7,0,0,38,38,83
1334912220000000000,7,0,0,38,39,84
1334912280000000000,7,0,0,39,38,84
1334912340000000000,7,0,0,1413,38,1458
1334912400000000000,7,0,0,1641,38,1686
1334912460000000000,7,0,1,1758,38,1804
1334912520000000000,7,0,0,1793,38,1838
1334912580000000000,7,0,0,1813,37,1857
1334912640000000000,7,0,0,1789,38,1834
1334912700000000000,7,0,148,1805,38,1998
1334912760000000000,7,0,135,1811,38,1991
1334912820000000000,7,0,128,1819,39,1993
1334912880000000000,7,0,127,1826,37,1997
1334912940000000000,7,0,127,1832,38,2004
1334913000000000000,7,0,125,1834,38,2004
1334913060000000000,7,0,124,1834,38,2003
1334913120000000000,7,0,124,1841,39,2011
1334913180000000000,7,0,123,1842,38,2010
1334913240000000000,7,0,122,1845,39,2013
1334913300000000000,7,0,122,1849,39,2017
1334913360000000000,7,0,0,1850,39,1896
1334913420000000000,7,0,0,1853,39,1899
1334913480000000000,7,0,0,1857,38,1902
1334913540000000000,7,0,0,1856,38,1901
1334913600000000000,7,0,0,166,37,210
1334913660000000000,7,0,0,0,38,45
1334913720000000000,7,0,0,1,38,46
1334913780000000000,7,0,0,1,38,46
1334913840000000000,7,0,10,0,38,55
1334913900000000000,7,0,7,1,39,54
1334913960000000000,7,0,0,1,39,47
1334914020000000000,7,0,0,1,38,46
1334914080000000000,7,0,0,1,38,46
1334914140000000000,7,0,0,1,38,46
1334914200000000000,7,0,0,1,39,47
1334914260000000000,7,0,1,1,38,47
1334914320000000000,7,0,0,1,38,46
1334914380000000000,7,0,0,0,38,45
1334914440000000000,7,0,0,0,38,45
1334914500000000000,7,0,0,0,39,46
1334914560000000000,7,0,1,1,38,47
1334914620000000000,7,0,0,1,38,46
1334914680000000000,7,0,0,1,38,46
1334914740000000000,7,0,0,1,38,46
1334914800000000000,7,0,0,39,38,84
1334914860000000000,7,0,0,39,38,84
1334914920000000000,7,0,0,38,38,83
1334914980000000000,7,0,0,38,38,83
1334915040000000000,7,0,0,38,38,83
1334915100000000000,7,0,0,38,38,83
1334915160000000000,7,0,0,38,38,83
1334915220000000000,7,0,0,38,38,83
1334915280000000000,7,0,143,38,39,227
1334915340000000000,7,0,131,38,38,214
1334915400000000000,7,0,128,37,38,210
1334915460000000000,7,0,127,37,37,208
1334915520000000000,7,0,128,38,38,211
1334915580000000000,7,0,126,38,38,209
1334915640000000000,7,0,125,39,38,209
1334915700000000000,7,0,124,38,38,207
1334915760000000000,7,0,122,38,37,204
1334915820000000000,7,0,122,38,38,205
1334915880000000000,7,0,0,38,38,83
1334915940000000000,7,0,0,38,38,83
1334916000000000000,7,0,0,38,39,84
1334916060000000000,7,0,0,39,38,84
1334916120000000000,7,0,0,37,38,82
1334916180000000000,7,0,0,38,38,83
1334916240000000000,7,0,0,38,38,83
1334916300000000000,7,0,0,38,38,83
1334916360000000000,7,0,0,38,37,82
1334916420000000000,7,0,1,38,38,84
1334916480000000000,7,0,0,38,38,83
1334916540000000000,7,0,0,38,38,83
1334916600000000000,7,0,0,38,38,83
1334916660000000000,6,0,0,39,38,83
1334916720000000000,7,0,0,37,38,82
1334916780000000000,7,0,0,37,39,83
1334916840000000000,7,0,0,1388,38,1433
1334916900000000000,7,0,0,1638,39,1684
1334916960000000000,7,0,0,1755,38,1800
1334917020000000000,7,0,0,1792,38,1837
1334917080000000000,7,0,0,1807,38,1852
1334917140000000000,7,0,0,1783,38,1828
1334917200000000000,7,0,0,1798,38,1843
1334917260000000000,7,0,0,1805,38,1850
1334917320000000000,7,0,0,1813,39,1859
1334917380000000000,7,0,1,1821,38,1867
1334917440000000000,7,0,0,1824,38,1869
1334917500000000000,7,0,7,1830,38,1882
1334917560000000000,7,0,0,1833,38,1878
1334917620000000000,7,0,0,1832,38,1877
1334917680000000000,7,0,0,1838,38,1883
1334917740000000000,7,0,0,1839,38,1884
1334917800000000000,7,0,0,1842,38,1887
1334917860000000000,7,0,151,1846,39,2043
1334917920000000000,7,0,138,1845,38,2028
1334917980000000000,7,0,129,1850,38,2024
1334918040000000000,7,0,127,1845,38,2017
1334918100000000000,7,0,127,1849,38,2021
1334918160000000000,7,0,126,1,39,173
1334918220000000000,7,0,125,0,38,170
1334918280000000000,7,0,124,1,38,170
1334918340000000000,7,0,123,1,37,168
1334918400000000000,7,0,123,1,38,169
1334918460000000000,7,0,122,1,38,168
1334918520000000000,7,0,1,1,38,47
1334918580000000000,7,0,0,1,38,46
1334918640000000000,7,0,0,1,39,47
1334918700000000000,7,0,0,1,37,45
1334918760000000000,7,0,0,0,38,45
1334918820000000000,7,0,0,1,38,46
1334918880000000000,7,0,1,1,38,47
1334918940000000000,7,0,7,1,37,52
1334919000000000000,7,0,7,1,39,54
1334919060000000000,7,0,7,0,38,52
1334919120000000000,7,0,8,1,37,53
1334919180000000000,7,0,7,0,38,52
1334919240000000000,7,0,7,1,38,53
1334919300000000000,7,0,7,1,38,53
1334919360000000000,7,0,7,42,38,94
1334919420000000000,7,0,7,38,38,90
1334919480000000000,7,0,7,38,37,89
1334919540000000000,7,0,152,38,38,235
1334919600000000000,7,0,140,37,37,221
1334919660000000000,7,0,136,38,38,219
1334919720000000000,7,0,135,37,38,217
1334919780000000000,7,0,134,38,38,217
1334919840000000000,7,0,134,38,39,218
1334919900000000000,7,0,133,38,39,217
1334919960000000000,8,0,132,37,38,215
1334920020000000000,7,0,131,37,38,213
1334920080000000000,7,0,131,37,38,213
1334920140000000000,7,0,132,38,38,215
1334920200000000000,7,0,130,38,38,213
1334920260000000000,7,0,130,38,38,213
1334920320000000000,7,0,130,37,38,212
1334920380000000000,7,0,130,38,39,214
1334920440000000000,7,0,129,37,38,211
1334920500000000000,7,0,129,38,39,213
1334920560000000000,7,0,132,38,38,215
1334920620000000000,7,0,126,37,39,209
1334920680000000000,7,0,126,38,39,210
1334920740000000000,7,0,123,38,38,206
1334920800000000000,7,0,1,37,38,83
1334920860000000000,7,0,1,38,38,84
1334920920000000000,7,0,0,38,38,83
1334920980000000000,7,0,0,38,38,83
1334921040000000000,7,0,1,37,38,83
1334921100000000000,7,0,0,38,37,82
1334921160000000000,7,0,0,38,38,83
1334921220000000000,7,0,0,38,38,83
1334921280000000000,7,0,0,1517,38,1562
1334921340000000000,7,0,0,1685,38,1730
1334921400000000000,7,0,0,1753,38,1798
1334921460000000000,7,0,0,1793,38,1838
1334921520000000000,7,0,0,1801,39,1847
1334921580000000000,7,0,0,1782,38,1827
1334921640000000000,7,0,0,1792,38,1837
1334921700000000000,7,0,0,1799,38,1844
1334921760000000000,7,0,0,1808,38,1853
1334921820000000000,7,0,0,1814,38,1859
1334921880000000000,7,0,0,1819,38,1864
1334921940000000000,7,0,0,1826,38,1871
1334922000000000000,7,0,0,1825,38,1870
1334922060000000000,7,0,1,1831,38,1877
1334922120000000000,7,0,0,1832,38,1877
1334922180000000000,7,0,0,1833,38,1878
1334922240000000000,7,0,0,1834,38,1879
1334922300000000000,7,0,0,1832,38,1877
1334922360000000000,7,0,0,1837,38,1882
1334922420000000000,7,0,0,1835,38,1880
1334922480000000000,7,0,1,1838,38,1884
1334922540000000000,7,0,0,1839,38,1884
1334922600000000000,7,0,1,1842,38,1888
1334922660000000000,7,0,0,1846,38,1891
1334922720000000000,7,0,0,1,37,45
1334922780000000000,7,0,0,1,38,46
1334922840000000000,7,0,139,1,38,185
1334922900000000000,7,0,142,1,37,187
1334922960000000000,7,0,130,1,38,176
1334923020000000000,7,0,127,1,38,173
1334923080000000000,7,0,127,1,38,173
1334923140000000000,7,0,126,1,38,172
1334923200000000000,7,0,125,1,38,171
1334923260000000000,7,0,125,1,38,171
1334923320000000000,7,0,123,1,39,170
1334923380000000000,7,0,123,1,38,169
1334923440000000000,7,0,122,1,39,169
1334923500000000000,7,0,0,1,38,46
1334923560000000000,7,0,0,1,38,46
1334923620000000000,7,0,0,0,38,45
1334923680000000000,7,0,0,1,39,47
1334923740000000000,7,0,0,1,38,46
1334923800000000000,7,0,0,1,38,46
1334923860000000000,7,0,1,41,38,87
1334923920000000000,7,0,0,39,38,84
1334923980000000000,7,0,0,38,38,83
1334924040000000000,7,0,1,38,38,84
1334924100000000000,7,0,1,38,38,84
1334924160000000000,7,0,10,38,38,93
1334924220000000000,7,0,10,36,38,91
1334924280000000000,7,0,0,37,38,82
1334924340000000000,7,0,0,38,38,83
1334924400000000000,7,0,0,38,38,83
1334924460000000000,7,0,0,36,38,81
1334924520000000000,7,0,0,38,38,83
1334924580000000000,7,0,0,36,38,81
1334924640000000000,7,0,0,36,38,81
1334924700000000000,7,0,0,38,39,84
1334924760000000000,7,0,0,37,38,82
1334924820000000000,7,0,0,38,37,82
1334924880000000000,7,0,0,37,38,82
1334924940000000000,7,0,0,38,38,83
1334925000000000000,7,0,0,37,38,82
1334925060000000000,7,0,0,37,38,82
1334925120000000000,7,0,0,37,38,82
1334925180000000000,7,0,0,37,38,82
1334925240000000000,7,0,0,38,38,83
1334925300000000000,7,0,1,37,38,83
1334925360000000000,7,0,0,38,38,83
1334925420000000000,7,0,144,37,38,226
1334925480000000000,7,0,132,38,37,214
1334925540000000000,7,0,128,39,38,212
1334925600000000000,7,0,127,38,38,210
1334925660000000000,7,0,126,1512,38,1683
1334925720000000000,7,0,124,1686,38,1855
1334925780000000000,7,0,124,1752,38,1921
1334925840000000000,7,0,123,1787,38,1955
1334925900000000000,7,0,122,1800,38,1967
1334925960000000000,7,0,121,1769,38,1935
1334926020000000000,7,0,0,1783,39,1829
1334926080000000000,7,0,0,1792,38,1837
1334926140000000000,7,0,0,1794,38,1839
1334926200000000000,7,0,0,1799,38,1844
1334926260000000000,7,0,0,1811,38,1856
1334926320000000000,7,0,0,1813,39,1859
1334926380000000000,7,0,0,1821,38,1866
1334926440000000000,7,0,0,1810,38,1855
1334926500000000000,7,0,0,1818,38,1863
1334926560000000000,7,0,0,1826,38,1871
1334926620000000000,7,0,0,1823,38,1868
1334926680000000000,7,0,0,1822,38,1867
1334926740000000000,7,0,0,1823,38,1868
1334926800000000000,7,0,0,1829,38,1874
1334926860000000000,7,0,0,1830,38,1875
1334926920000000000,7,0,0,1830,37,1874
1334926980000000000,7,0,0,1822,38,1867
1334927040000000000,7,0,0,1816,38,1861
1334927100000000000,7,0,0,1827,38,1872
1334927160000000000,7,0,0,1,38,46
1334927220000000000,7,0,0,1,38,46
1334927280000000000,7,0,0,1,37,45
1334927340000000000,7,0,0,1,38,46
1334927400000000000,7,0,0,1,38,46
1334927460000000000,7,0,0,0,38,45
1334927520000000000,7,0,0,1,38,46
1334927580000000000,7,0,1,1,38,47
1334927640000000000,7,0,1,1,38,47
1334927700000000000,7,0,1,1,38,47
1334927760000000000,7,0,0,0,38,45
1334927820000000000,7,0,10,1,39,57
1334927880000000000,7,0,7,1,39,54
1334927940000000000,7,0,0,1,39,47
1334928000000000000,7,0,0,0,38,45
1334928060000000000,7,0,0,1,38,46
1334928120000000000,7,0,149,1,38,195
1334928180000000000,7,0,136,1,39,183
1334928240000000000,7,0,130,1,38,176
1334928300000000000,7,0,128,39,38,212
1334928360000000000,7,0,126,39,38,210
1334928420000000000,7,0,125,38,38,208
1334928480000000000,7,0,124,38,38,207
1334928540000000000,7,0,124,37,38,206
1334928600000000000,7,0,123,37,38,205
1334928660000000000,7,0,122,38,38,205
1334928720000000000,7,0,121,38,38,204
1334928780000000000,7,0,0,38,38,83
1334928840000000000,7,0,0,36,37,80
1334928900000000000,7,0,0,37,38,82
1334928960000000000,7,0,0,37,38,82
1334929020000000000,7,0,1,37,38,83
1334929080000000000,7,0,0,37,38,82
1334929140000000000,7,0,0,38,39,84
1334929200000000000,7,0,1,37,39,84
1334929260000000000,7,0,0,37,38,82
1334929320000000000,7,0,0,38,38,83
1334929380000000000,7,0,0,37,38,82
1334929440000000000,7,0,7,37,39,90
1334929500000000000,7,0,7,37,38,89
1334929560000000000,7,0,7,38,38,90
1334929620000000000,7,0,7,37,38,89
1334929680000000000,7,0,7,37,38,89
1334929740000000000,7,0,7,36,38,88
1334929800000000000,7,0,7,37,38,89
1334929860000000000,7,0,7,37,38,89
1334929920000000000,7,0,7,38,38,90
1334929980000000000,7,0,147,37,38,229
1334930040000000000,7,0,138,38,38,221
1334930100000000000,7,0,135,37,38,217
1334930160000000000,7,0,134,36,38,215
1334930220000000000,7,0,133,38,38,216
1334930280000000000,7,0,132,1533,38,1710
1334930340000000000,7,0,132,1695,37,1871
1334930400000000000,7,0,131,1752,38,1928
1334930460000000000,7,0,131,1779,38,1955
1334930520000000000,7,0,130,1794,37,1968
1334930580000000000,7,0,129,1767,38,1941
1334930640000000000,7,0,128,1783,37,1955
1334930700000000000,7,0,128,1787,38,1960
1334930760000000000,7,0,128,1798,38,1971
1334930820000000000,7,0,129,1802,37,1975
1334930880000000000,7,0,129,1808,38,1982
1334930940000000000,7,0,127,1809,38,1981
1334931000000000000,7,0,127,1808,38,1980
1334931060000000000,7,0,125,1817,38,1987
1334931120000000000,7,0,123,1817,38,1985
1334931180000000000,7,0,122,1817,37,1983
1334931240000000000,7,0,0,1822,37,1866
1334931300000000000,7,0,0,1825,38,1870
1334931360000000000,7,0,0,1824,38,1869
1334931420000000000,7,0,1,1824,37,1869
1334931480000000000,7,0,0,1826,38,1871
1334931540000000000,7,0,0,1826,38,1871
1334931600000000000,7,0,0,1829,38,1874
1334931660000000000,7,0,0,1829,39,1875
1334931720000000000,7,0,0,1,38,46
1334931780000000000,7,0,0,0,38,45
1334931840000000000,7,0,0,1,38,46
1334931900000000000,7,0,0,0,38,45
1334931960000000000,7,0,0,1,38,46
1334932020000000000,7,0,0,1,37,45
1334932080000000000,7,0,0,0,38,45
1334932140000000000,7,0,0,1,38,46
1334932200000000000,7,0,0,1,38,46
1334932260000000000,7,0,0,1,38,46
1334932320000000000,7,0,0,1,38,46
1334932380000000000,7,0,0,1,37,45
1334932440000000000,7,0,0,1,38,46
1334932500000000000,7,0,0,1,39,47
1334932560000000000,7,0,0,1,38,46
1334932620000000000,7,0,0,1,38,46
1334932680000000000,7,0,0,1,38,46
1334932740000000000,7,0,0,1,38,46
1334932800000000000,7,0,0,1,37,45
1334932860000000000,7,0,0,1,37,45
1334932920000000000,7,0,0,39,38,84
1334932980000000000,7,0,0,38,38,83
1334933040000000000,7,0,0,37,38,82
1334933100000000000,7,0,0,37,38,82
1334933160000000000,7,0,1,36,37,81
1334933220000000000,7,0,0,36,38,81
1334933280000000000,7,0,147,36,38,228
1334933340000000000,7,0,138,38,38,221
1334933400000000000,7,0,129,38,38,212
1334933460000000000,7,0,127,37,38,209
1334933520000000000,7,0,127,37,38,209
1334933580000000000,7,0,126,38,38,209
1334933640000000000,7,0,124,36,38,205
1334933700000000000,7,0,123,37,38,205
1334933760000000000,7,0,122,36,38,203
1334933820000000000,7,0,122,37,38,204
1334933880000000000,7,0,121,37,38,203
1334933940000000000,7,0,0,36,38,81
1334934000000000000,7,0,0,37,38,82
1334934060000000000,7,0,0,37,38,82
1334934120000000000,7,0,0,1301,38,1346
1334934180000000000,7,0,0,1620,38,1665
1334934240000000000,7,0,0,1742,39,1788
1334934300000000000,7,0,0,1785,38,1830
1334934360000000000,7,0,0,1802,38,1847
1334934420000000000,7,0,0,1773,38,1818
1334934480000000000,7,0,0,1789,38,1834
1334934540000000000,7,0,0,1794,38,1839
1334934600000000000,7,0,0,1808,38,1853
1334934660000000000,7,0,10,1813,38,1868
1334934720000000000,7,0,0,1814,38,1859
1334934780000000000,7,0,0,1817,38,1862
1334934840000000000,7,0,0,1816,38,1861
1334934900000000000,7,0,0,1822,38,1867
1334934960000000000,7,0,1,1822,38,1868
1334935020000000000,7,0,0,1822,39,1868
1334935080000000000,7,0,0,1819,39,1865
1334935140000000000,7,0,0,1832,38,1877
1334935200000000000,7,0,0,1839,39,1885
1334935260000000000,7,0,0,1831,38,1876
1334935320000000000,7,0,0,1830,37,1874
1334935380000000000,7,0,0,1,38,46
1334935440000000000,7,0,0,1,38,46
1334935500000000000,7,0,0,1,38,46
1334935560000000000,7,0,0,1,38,46
1334935620000000000,7,0,0,1,38,46
1334935680000000000,7,0,0,1,38,46
1334935740000000000,7,0,0,1,39,47
1334935800000000000,7,0,1,1,38,47
1334935860000000000,7,0,144,0,38,189
1334935920000000000,7,0,132,0,38,177
1334935980000000000,7,0,128,1,38,174
1334936040000000000,7,0,127,0,38,172
1334936100000000000,7,0,127,1,38,173
1334936160000000000,7,0,125,0,38,170
1334936220000000000,7,0,124,1,38,170
1334936280000000000,7,0,122,1,38,168
1334936340000000000,7,0,122,1,38,168
1334936400000000000,7,0,122,1,38,168
1334936460000000000,7,0,0,1,37,45
1334936520000000000,7,0,0,41,38,86
1334936580000000000,7,0,0,38,39,84
1334936640000000000,7,0,1,37,39,84
1334936700000000000,7,0,0,39,39,85
1334936760000000000,7,0,0,38,38,83
1334936820000000000,7,0,0,38,38,83
1334936880000000000,7,0,1,37,39,84
1334936940000000000,7,0,0,38,38,83
1334937000000000000,7,0,0,37,39,83
1334937060000000000,7,0,0,36,38,81
1334937120000000000,7,0,0,38,38,83
1334937180000000000,7,0,0,38,38,83
1334937240000000000,7,0,0,37,38,82
1334937300000000000,7,0,0,37,38,82
1334937360000000000,7,0,0,36,38,81
1334937420000000000,7,0,0,38,37,82
1334937480000000000,7,0,0,38,38,83
1334937540000000000,7,0,1,37,38,83
1334937600000000000,7,0,1,36,38,82
1334937660000000000,7,0,1,37,38,83
1334937720000000000,7,0,1,37,38,83
1334937780000000000,7,0,1,36,38,82
1334937840000000000,7,0,1,36,37,81
1334937900000000000,7,0,0,36,38,81
1334937960000000000,7,0,0,38,38,83
1334938020000000000,7,0,0,38,38,83
1334938080000000000,7,0,0,38,38,83
1334938140000000000,7,0,0,38,38,83
1334938200000000000,7,0,0,37,38,82
1334938260000000000,7,0,10,37,38,92
1334938320000000000,7,0,10,38,38,93
1334938380000000000,7,0,0,37,38,82
1334938440000000000,7,0,0,37,38,82
1334938500000000000,7,0,0,36,38,81
1334938560000000000,7,0,150,38,37,232
1334938620000000000,7,0,139,37,38,221
1334938680000000000,7,0,139,37,38,221
1334938740000000000,7,0,138,37,38,220
1334938800000000000,7,0,138,37,38,220
1334938860000000000,7,0,137,38,38,220
1334938920000000000,7,0,137,36,38,218
1334938980000000000,7,0,135,37,39,218
1334939040000000000,7,0,134,36,38,215
1334939100000000000,7,0,133,38,39,217
1334939160000000000,7,0,132,37,38,214
1334939220000000000,7,0,132,37,38,214
1334939280000000000,7,0,132,37,38,214
1334939340000000000,7,0,211,36,38,292
1334939400000000000,7,0,132,36,38,213
1334939460000000000,7,0,132,38,37,214
1334939520000000000,7,0,132,37,37,213
1334939580000000000,7,0,132,36,38,213
1334939640000000000,7,0,130,37,37,211
1334939700000000000,7,0,129,37,38,211
1334939760000000000,7,0,130,37,39,213
1334939820000000000,7,0,129,36,38,210
1334939880000000000,7,0,129,37,38,211
1334939940000000000,7,0,129,37,38,211
1334940000000000000,7,0,128,36,38,209
1334940060000000000,7,0,130,38,38,213
1334940120000000000,7,0,128,37,38,210
1334940180000000000,7,0,127,36,38,208
1334940240000000000,7,0,127,37,39,210
1334940300000000000,7,0,127,38,38,210
1334940360000000000,7,0,7,37,39,90
1334940420000000000,7,0,7,37,38,89
1334940480000000000,7,0,7,36,38,88
1334940540000000000,7,0,10,37,39,93
1334940600000000000,7,0,1,37,38,83
1334940660000000000,7,0,1,37,38,83
1334940720000000000,7,0,0,37,38,82
1334940780000000000,7,0,0,36,38,81
1334940840000000000,7,0,0,36,38,81
1334940900000000000,7,0,0,36,37,80
1334940960000000000,7,0,1,36,38,82
1334941020000000000,7,0,0,37,38,82
1334941080000000000,7,0,1,37,38,83
1334941140000000000,7,0,144,36,38,225
1334941200000000000,7,0,132,36,38,213
1334941260000000000,7,0,128,36,38,209
1334941320000000000,7,0,125,38,38,208
1334941380000000000,7,0,125,38,38,208
1334941440000000000,7,0,124,36,38,205
1334941500000000000,7,0,123,36,38,204
1334941560000000000,7,0,123,38,39,207
1334941620000000000,7,0,121,38,38,204
1334941680000000000,7,0,122,37,38,204
1334941740000000000,7,0,0,36,37,80
1334941800000000000,7,0,0,37,38,82
1334941860000000000,7,0,0,37,39,83
1334941920000000000,7,0,0,38,38,83
1334941980000000000,7,0,0,36,38,81
1334942040000000000,7,0,1,38,38,84
1334942100000000000,7,0,0,37,38,82
1334942160000000000,7,0,0,37,38,82
1334942220000000000,7,0,1,37,38,83
1334942280000000000,7,0,0,37,38,82
1334942340000000000,7,0,0,37,38,82
1334942400000000000,7,0,0,37,38,82
1334942460000000000,7,0,0,36,38,81
1334942520000000000,7,0,0,37,38,82
1334942580000000000,7,0,0,36,38,81
1334942640000000000,7,0,0,36,38,81
1334942700000000000,7,0,0,36,38,81
1334942760000000000,7,0,0,36,38,81
1334942820000000000,7,0,1,37,38,83
1334942880000000000,7,0,1,38,38,84
1334942940000000000,7,0,0,37,38,82
1334943000000000000,7,0,0,37,39,83
1334943060000000000,7,0,0,38,38,83
1334943120000000000,7,0,0,38,38,83
1334943180000000000,7,0,0,36,38,81
1334943240000000000,7,0,0,36,38,81
1334943300000000000,7,0,0,37,38,82
1334943360000000000,7,0,0,37,38,82
1334943420000000000,7,0,0,37,38,82
1334943480000000000,7,0,0,38,38,83
1334943540000000000,7,0,0,36,38,81
1334943600000000000,7,0,1,36,38,82
1334943660000000000,7,0,0,36,38,81
1334943720000000000,7,0,0,37,38,82
1334943780000000000,7,0,0,37,38,82
1334943840000000000,7,0,0,38,38,83
1334943900000000000,7,0,0,36,38,81
1334943960000000000,7,0,0,37,38,82
1334944020000000000,7,0,141,37,38,223
1334944080000000000,7,0,132,36,37,212
1334944140000000000,7,0,131,37,38,213
1334944200000000000,7,0,128,36,38,209
1334944260000000000,7,0,128,37,38,210
1334944320000000000,7,0,125,38,38,208
1334944380000000000,7,0,125,38,38,208
1334944440000000000,7,0,124,37,38,206
1334944500000000000,7,0,123,38,38,206
1334944560000000000,7,0,122,36,38,203
1334944620000000000,7,0,121,36,38,202
1334944680000000000,7,0,0,37,38,82
1334944740000000000,7,0,0,36,38,81
1334944800000000000,7,0,0,37,38,82
1334944860000000000,7,0,0,36,38,81
1334944920000000000,7,0,0,36,38,81
1334944980000000000,7,0,0,37,38,82
1334945040000000000,7,0,0,37,38,82
1334945100000000000,7,0,0,37,38,82
1334945160000000000,7,0,0,37,37,81
1334945220000000000,7,0,0,36,38,81
1334945280000000000,7,0,0,36,38,81
1334945340000000000,7,0,0,37,37,81
1334945400000000000,7,0,0,36,38,81
1334945460000000000,7,0,0,37,38,82
1334945520000000000,7,0,0,36,38,81
1334945580000000000,7,0,0,37,38,82
1334945640000000000,7,0,1,37,38,83
1334945700000000000,7,0,0,37,39,83
1334945760000000000,7,0,0,38,38,83
1334945820000000000,7,0,0,36,38,81
1334945880000000000,7,0,0,37,39,83
1334945940000000000,7,0,0,36,38,81
1334946000000000000,7,0,0,37,37,81
1334946060000000000,7,0,0,36,38,81
1334946120000000000,7,0,0,36,38,81
1334946180000000000,7,0,0,38,38,83
1334946240000000000,7,0,0,38,38,83
1334946300000000000,7,0,0,37,38,82
1334946360000000000,7,0,0,37,38,82
1334946420000000000,7,0,0,37,38,82
1334946480000000000,7,0,81,36,39,163
1334946540000000000,7,0,1,37,38,83
1334946600000000000,7,0,0,37,38,82
1334946660000000000,7,0,0,36,38,81
1334946720000000000,7,0,10,37,38,92
1334946780000000000,7,0,7,36,38,88
1334946840000000000,7,0,7,37,38,89
1334946900000000000,7,0,148,36,38,229
1334946960000000000,7,0,140,36,39,222
1334947020000000000,7,0,138,37,38,220
1334947080000000000,7,0,138,37,38,220
1334947140000000000,7,0,137,37,38,219
1334947200000000000,7,0,137,37,38,219
1334947260000000000,7,0,135,36,37,215
1334947320000000000,7,0,133,37,37,214
1334947380000000000,7,0,134,37,38,216
1334947440000000000,7,0,132,38,38,215
1334947500000000000,7,0,131,37,38,213
1334947560000000000,7,0,131,37,37,212
1334947620000000000,7,0,132,36,39,214
1334947680000000000,7,0,130,38,37,212
1334947740000000000,7,0,130,37,37,211
1334947800000000000,7,0,130,37,39,213
1334947860000000000,7,0,129,37,38,211
1334947920000000000,7,0,128,36,37,208
1334947980000000000,7,0,128,36,38,209
1334948040000000000,7,0,128,36,38,209
1334948100000000000,7,0,127,37,39,210
1334948160000000000,7,0,127,36,39,209
1334948220000000000,7,0,127,36,37,207
1334948280000000000,7,0,127,35,38,207
1334948340000000000,7,0,127,36,38,208
1334948400000000000,7,0,127,36,38,208
1334948460000000000,7,0,7,37,38,89
1334948520000000000,7,0,7,36,38,88
1334948580000000000,7,0,7,37,38,89
1334948640000000000,7,0,7,35,38,87
1334948700000000000,7,0,7,37,39,90
1334948760000000000,7,0,7,36,38,88
1334948820000000000,7,0,0,37,38,82
1334948880000000000,7,0,0,38,37,82
1334948940000000000,7,0,0,38,38,83
1334949000000000000,7,0,0,37,38,82
1334949060000000000,7,0,132,37,38,214
1334949120000000000,7,0,143,37,38,225
1334949180000000000,7,0,130,37,38,212
1334949240000000000,7,0,128,37,38,210
1334949300000000000,7,0,127,38,38,210
1334949360000000000,7,0,126,37,37,207
1334949420000000000,7,0,124,36,38,205
1334949480000000000,7,0,123,35,38,203
1334949540000000000,7,0,122,36,38,203
1334949600000000000,7,0,123,37,38,205
1334949660000000000,7,0,122,36,38,203
1334949720000000000,7,0,0,37,38,82
1334949780000000000,7,0,0,36,38,81
1334949840000000000,7,0,0,36,38,81
1334949900000000000,7,0,1,36,38,82
1334949960000000000,7,0,0,36,38,81
1334950020000000000,7,0,0,37,38,82
1334950080000000000,7,0,0,36,38,81
1334950140000000000,7,0,0,37,38,82
1334950200000000000,7,0,0,36,38,81
1334950260000000000,7,0,0,37,38,82
1334950320000000000,7,0,0,38,38,83
1334950380000000000,7,0,0,37,38,82
1334950440000000000,7,0,0,37,38,82
1334950500000000000,7,0,0,38,38,83
1334950560000000000,7,0,0,38,38,83
1334950620000000000,7,0,0,36,38,81
1334950680000000000,7,0,0,37,38,82
1334950740000000000,7,0,0,37,37,81
1334950800000000000,7,0,0,37,38,82
1334950860000000000,7,0,0,38,38,83
1334950920000000000,7,0,0,37,38,82
1334950980000000000,7,0,0,35,38,80
1334951040000000000,7,0,0,36,37,80
1334951100000000000,7,0,0,37,39,83
1334951160000000000,7,0,0,37,38,82
1334951220000000000,7,0,0,37,39,83
1334951280000000000,7,0,0,36,39,82
1334951340000000000,7,0,1,37,39,84
1334951400000000000,7,0,0,37,38,82
1334951460000000000,7,0,0,38,38,83
1334951520000000000,7,0,0,38,38,83
1334951580000000000,7,0,0,37,38,82
1334951640000000000,7,0,0,38,38,83
1334951700000000000,8,0,0,37,38,83
1334951760000000000,7,0,0,37,38,82
1334951820000000000,7,0,0,36,38,81
1334951880000000000,7,0,0,36,38,81
1334951940000000000,7,0,1,37,39,84
1334952000000000000,7,0,147,36,38,228
1334952060000000000,7,0,136,37,38,218
1334952120000000000,7,0,128,37,39,211
1334952180000000000,7,0,127,38,38,210
1334952240000000000,7,0,126,36,38,207
1334952300000000000,7,0,126,37,38,208
1334952360000000000,7,0,124,36,38,205
1334952420000000000,7,0,125,36,38,206
1334952480000000000,7,0,125,37,38,207
1334952540000000000,7,0,122,37,38,204
1334952600000000000,7,0,125,36,39,207
1334952660000000000,7,0,124,36,38,205
1334952720000000000,7,0,123,37,38,205
1334952780000000000,7,0,0,36,38,81
1334952840000000000,7,0,0,36,38,81
1334952900000000000,7,0,0,37,38,82
1334952960000000000,7,0,1,37,38,83
1334953020000000000,7,0,0,37,38,82
1334953080000000000,7,0,0,36,37,80
1334953140000000000,7,0,0,38,38,83
1334953200000000000,7,0,0,37,38,82
1334953260000000000,7,0,1,37,38,83
1334953320000000000,7,0,0,37,39,83
1334953380000000000,7,0,0,37,39,83
1334953440000000000,7,0,0,38,38,83
1334953500000000000,7,0,0,37,38,82
1334953560000000000,7,0,0,37,38,82
1334953620000000000,7,0,0,36,38,81
1334953680000000000,7,0,0,38,38,83
1334953740000000000,7,0,0,37,37,81
1334953800000000000,7,0,0,36,38,81
1334953860000000000,7,0,0,37,38,82
1334953920000000000,7,0,0,37,39,83
1334953980000000000,7,0,0,37,38,82
1334954040000000000,7,0,0,37,38,82
1334954100000000000,7,0,1,38,38,84
1334954160000000000,7,0,0,37,38,82
1334954220000000000,7,0,0,38,38,83
1334954280000000000,7,0,0,37,38,82
1334954340000000000,7,0,0,36,39,82
1334954400000000000,7,0,0,38,38,83
1334954460000000000,7,0,0,37,38,82
1334954520000000000,7,0,0,37,38,82
1334954580000000000,7,0,0,37,38,82
1334954640000000000,7,0,1,37,38,83
1334954700000000000,7,0,0,37,38,82
1334954760000000000,7,0,0,37,38,82
1334954820000000000,7,0,1,38,38,84
1334954880000000000,7,0,143,38,38,226
1334954940000000000,7,0,138,37,39,221
1334955000000000000,7,0,129,37,38,211
1334955060000000000,7,0,128,37,38,210
1334955120000000000,7,0,128,37,38,210
1334955180000000000,7,0,127,37,38,209
1334955240000000000,7,0,124,37,38,206
1334955300000000000,7,0,124,36,38,205
1334955360000000000,7,0,124,37,39,207
1334955420000000000,7,0,122,37,38,204
1334955480000000000,7,0,122,38,38,205
1334955540000000000,7,0,0,37,38,82
1334955600000000000,7,0,0,37,38,82
1334955660000000000,7,0,0,36,39,82
1334955720000000000,7,0,0,37,39,83
1334955780000000000,7,0,0,37,39,83
1334955840000000000,7,0,0,38,38,83
1334955900000000000,7,0,0,37,38,82
1334955960000000000,7,0,0,37,38,82
1334956020000000000,7,0,10,38,38,93
1334956080000000000,7,0,0,38,39,84
1334956140000000000,7,0,0,38,38,83
1334956200000000000,7,0,0,38,38,83
1334956260000000000,7,0,1,37,38,83
1334956320000000000,7,0,1,37,38,83
1334956380000000000,7,0,0,36,38,81
1334956440000000000,7,0,0,38,38,83
1334956500000000000,7,0,0,37,39,83
1334956560000000000,7,0,0,36,38,81
1334956620000000000,7,0,0,38,38,83
1334956680000000000,7,0,0,36,38,81
1334956740000000000,7,0,1,38,38,84
1334956800000000000,7,0,10,37,38,92
1334956860000000000,7,0,7,37,38,89
1334956920000000000,7,0,7,38,38,90
1334956980000000000,7,0,7,36,39,89
1334957040000000000,7,0,7,37,38,89
1334957100000000000,7,0,7,38,38,90
1334957160000000000,7,0,147,37,38,229
1334957220000000000,7,0,141,37,38,223
1334957280000000000,7,0,138,37,38,220
1334957340000000000,7,0,136,37,38,218
1334957400000000000,7,0,135,36,37,215
1334957460000000000,7,0,133,38,38,216
1334957520000000000,7,0,132,36,38,213
1334957580000000000,7,0,132,37,38,214
1334957640000000000,7,0,132,37,38,214
1334957700000000000,7,0,131,37,39,214
1334957760000000000,7,0,131,38,38,214
1334957820000000000,7,0,130,37,38,212
1334957880000000000,7,0,130,38,39,214
1334957940000000000,7,0,131,37,38,213
1334958000000000000,7,0,129,37,38,211
1334958060000000000,7,0,128,37,37,209
1334958120000000000,7,0,128,37,39,211
1334958180000000000,7,0,128,36,38,209
1334958240000000000,7,0,128,36,38,209
1334958300000000000,7,0,127,37,38,209
1334958360000000000,7,0,128,38,38,211
1334958420000000000,7,0,129,37,38,211
1334958480000000000,7,0,128,37,38,210
1334958540000000000,7,0,127,36,38,208
1334958600000000000,7,0,127,37,38,209
1334958660000000000,7,0,0,37,38,82
1334958720000000000,7,0,0,38,38,83
1334958780000000000,335,0,0,37,218,590
1334958840000000000,335,0,0,37,179,551
1334958900000000000,334,0,0,36,177,547
1334958960000000000,335,0,0,37,183,555
1334959020000000000,334,0,0,37,221,592
1334959080000000000,334,0,0,36,233,603
1334959140000000000,334,0,0,36,195,565
1334959200000000000,333,0,0,37,195,565
1334959260000000000,333,0,0,37,227,597
1334959320000000000,334,0,0,36,293,663
1334959380000000000,334,0,0,37,225,596
1334959440000000000,333,0,0,37,214,584
1334959500000000000,333,0,0,36,201,570
1334959560000000000,334,0,0,36,254,624
1334959620000000000,333,0,0,36,256,625
1334959680000000000,335,0,0,37,192,564
1334959740000000000,334,0,0,36,188,558
1334959800000000000,335,0,0,37,184,556
1334959860000000000,336,0,0,37,252,625
1334959920000000000,338,0,0,38,205,581
1334959980000000000,336,0,0,37,197,570
1334960040000000000,335,0,0,36,195,566
1334960100000000000,339,0,0,36,178,553
1334960160000000000,337,0,0,38,178,553
1334960220000000000,333,0,147,36,175,691
1334960280000000000,333,0,135,37,191,696
1334960340000000000,334,0,128,36,191,689
1334960400000000000,335,0,126,37,220,718
1334960460000000000,335,0,125,36,204,700
1334960520000000000,336,0,124,37,190,687
1334960580000000000,337,0,123,37,185,682
1334960640000000000,336,0,123,36,209,704
1334960700000000000,336,0,122,37,185,680
1334960760000000000,336,0,121,38,196,691
1334960820000000000,334,0,121,37,196,688
1334960880000000000,335,0,0,36,186,557
1334960940000000000,335,0,0,38,215,588
1334961000000000000,335,0,0,36,193,564
1334961060000000000,339,0,0,38,196,573
1334961120000000000,339,0,0,36,244,619
1334961180000000000,337,0,0,37,197,571
1334961240000000000,334,0,0,38,175,547
1334961300000000000,335,0,0,36,175,546
1334961360000000000,335,0,0,37,216,588
1334961420000000000,335,0,0,38,174,547
1334961480000000000,335,0,0,37,189,561
1334961540000000000,334,0,0,37,392,763
1334961600000000000,8,0,1,37,36,82
1334961660000000000,7,0,0,37,37,81
1334961720000000000,7,0,0,38,37,82
1334961780000000000,7,0,0,36,37,80
1334961840000000000,7,0,0,36,38,81
1334961900000000000,7,0,0,37,37,81
1334961960000000000,7,0,0,37,37,81
1334962020000000000,7,0,1,37,38,83
1334962080000000000,7,0,1,38,37,83
1334962140000000000,7,0,0,37,37,81
1334962200000000000,7,0,1,37,37,82
1334962260000000000,7,0,10,37,37,91
1334962320000000000,7,0,0,38,37,82
1334962380000000000,7,0,1,37,37,82
1334962440000000000,7,0,1,36,37,81
1334962500000000000,7,0,1,36,38,82
1334962560000000000,7,0,0,35,37,79
1334962620000000000,7,0,1,37,38,83
1334962680000000000,7,0,0,37,37,81
1334962740000000000,7,0,0,36,38,81
1334962800000000000,7,0,148,37,37,229
1334962860000000000,7,0,134,37,38,216
1334962920000000000,7,0,129,37,37,210
1334962980000000000,7,0,127,36,37,207
1334963040000000000,7,0,127,37,37,208
1334963100000000000,7,0,125,37,37,206
1334963160000000000,7,0,124,36,38,205
1334963220000000000,335,0,123,36,37,531
1334963280000000000,338,0,122,36,37,533
1334963340000000000,334,0,122,37,37,530
1334963400000000000,387,0,121,38,38,584
1334963460000000000,384,0,0,37,37,458
1334963520000000000,380,0,0,37,37,454
1334963580000000000,379,0,0,37,37,453
1334963640000000000,375,0,0,37,38,450
1334963700000000000,379,0,0,37,37,453
1334963760000000000,378,0,0,38,37,453
1334963820000000000,377,0,0,36,37,450
1334963880000000000,379,0,0,36,37,452
1334963940000000000,382,0,0,37,37,456
1334964000000000000,379,0,0,38,37,454
1334964060000000000,381,0,0,38,38,457
1334964120000000000,382,0,0,38,37,457
1334964180000000000,380,0,0,36,37,453
1334964240000000000,381,0,0,37,37,455
1334964300000000000,385,0,0,38,38,461
1334964360000000000,7,0,0,37,37,81
1334964420000000000,7,0,1,37,37,82
1334964480000000000,7,0,0,38,37,82
1334964540000000000,7,0,0,37,38,82
1334964600000000000,7,0,0,37,38,82
1334964660000000000,7,0,0,37,37,81
1334964720000000000,7,0,0,36,38,81
1334964780000000000,7,0,0,36,37,80
1334964840000000000,7,0,0,37,38,82
1334964900000000000,7,0,0,37,38,82
1334964960000000000,7,0,0,37,37,81
1334965020000000000,7,0,0,38,37,82
1334965080000000000,7,0,0,38,37,82
1334965140000000000,7,0,0,37,37,81
1334965200000000000,7,0,0,36,37,80
1334965260000000000,7,0,0,36,38,81
1334965320000000000,7,0,0,36,38,81
1334965380000000000,7,0,0,38,38,83
1334965440000000000,7,0,1,38,38,84
1334965500000000000,7,0,0,37,38,82
1334965560000000000,7,0,0,36,37,80
1334965620000000000,7,0,0,37,37,81
1334965680000000000,7,0,1,37,37,82
1334965740000000000,7,0,0,38,38,83
1334965800000000000,7,0,141,36,37,221
1334965860000000000,7,0,180,36,38,261
1334965920000000000,7,0,142,37,37,223
1334965980000000000,7,0,137,37,38,219
1334966040000000000,7,0,137,36,38,218
1334966100000000000,7,0,137,36,37,217
1334966160000000000,7,0,136,37,37,217
1334966220000000000,7,0,134,37,38,216
1334966280000000000,7,0,134,37,38,216
1334966340000000000,7,0,134,37,37,215
1334966400000000000,7,0,132,37,37,213
1334966460000000000,7,0,133,37,37,214
1334966520000000000,7,0,132,36,37,212
1334966580000000000,7,0,131,36,37,211
1334966640000000000,7,0,131,36,37,211
1334966700000000000,7,0,130,37,37,211
1334966760000000000,7,0,130,36,37,210
1334966820000000000,7,0,131,38,37,213
1334966880000000000,7,0,129,37,37,210
1334966940000000000,7,0,129,38,38,212
1334967000000000000,7,0,128,38,37,210
1334967060000000000,7,0,128,37,38,210
1334967120000000000,7,0,128,37,37,209
1334967180000000000,7,0,128,36,38,209
1334967240000000000,7,0,127,37,37,208
1334967300000000000,7,0,127,37,38,209
1334967360000000000,7,0,127,37,38,209
1334967420000000000,7,0,127,38,37,209
1334967480000000000,7,0,127,37,37,208
1334967540000000000,7,0,126,37,37,207
1334967600000000000,7,0,0,37,37,81
1334967660000000000,7,0,0,38,37,82
1334967720000000000,7,0,0,38,38,83
1334967780000000000,7,0,0,37,38,82
1334967840000000000,7,0,0,37,38,82
1334967900000000000,7,0,0,37,37,81
1334967960000000000,7,0,0,37,37,81
1334968020000000000,7,0,0,38,38,83
1334968080000000000,7,0,0,38,37,82
1334968140000000000,7,0,0,37,37,81
1334968200000000000,7,0,0,37,38,82
1334968260000000000,7,0,0,37,37,81
1334968320000000000,7,0,1,38,37,83
1334968380000000000,7,0,0,36,37,80
1334968440000000000,7,0,0,36,37,80
1334968500000000000,7,0,0,37,38,82
1334968560000000000,7,0,0,39,38,84
1334968620000000000,7,0,0,38,38,83
1334968680000000000,7,0,0,38,37,82
1334968740000000000,7,0,0,38,37,82
1334968800000000000,7,0,0,38,38,83
1334968860000000000,7,0,0,38,38,83
1334968920000000000,7,0,42,37,38,124
1334968980000000000,7,0,154,37,37,235
1334969040000000000,7,0,145,38,38,228
1334969100000000000,7,0,144,37,38,226
1334969160000000000,7,0,140,37,38,222
1334969220000000000,7,0,139,37,37,220
1334969280000000000,7,0,138,38,37,220
1334969340000000000,7,0,136,38,37,218
1334969400000000000,7,0,135,38,37,217
1334969460000000000,7,0,133,37,37,214
1334969520000000000,7,0,134,37,37,215
1334969580000000000,7,0,130,37,37,211
1334969640000000000,7,0,130,37,37,211
1334969700000000000,7,0,129,37,37,210
1334969760000000000,7,0,128,37,37,209
1334969820000000000,7,0,129,38,37,211
1334969880000000000,7,0,126,38,37,208
1334969940000000000,7,0,127,37,37,208
1334970000000000000,7,0,125,37,37,206
1334970060000000000,7,0,125,38,38,208
1334970120000000000,7,0,125,37,38,207
1334970180000000000,7,0,0,39,37,83
1334970240000000000,7,0,0,37,37,81
1334970300000000000,7,0,0,36,37,80
1334970360000000000,7,0,1,37,38,83
1334970420000000000,7,0,0,36,38,81
1334970480000000000,7,0,0,37,37,81
1334970540000000000,7,0,0,37,37,81
1334970600000000000,7,0,7,36,38,88
1334970660000000000,7,0,7,38,37,89
1334970720000000000,7,0,7,37,37,88
1334970780000000000,7,0,7,37,37,88
1334970840000000000,7,0,7,36,37,87
1334970900000000000,7,0,7,37,38,89
1334970960000000000,7,0,7,38,38,90
1334971020000000000,7,0,160,38,37,242
1334971080000000000,7,0,145,37,37,226
1334971140000000000,7,0,140,36,38,221
1334971200000000000,7,0,139,37,37,220
1334971260000000000,7,0,138,36,38,219
1334971320000000000,7,0,137,37,37,218
1334971380000000000,7,0,137,37,38,219
1334971440000000000,7,0,135,37,37,216
1334971500000000000,7,0,137,37,37,218
1334971560000000000,7,0,136,37,37,217
1334971620000000000,7,0,136,37,38,218
1334971680000000000,7,0,135,37,38,217
1334971740000000000,7,0,134,38,37,216
1334971800000000000,7,0,134,36,37,214
1334971860000000000,7,0,133,37,37,214
1334971920000000000,7,0,133,38,38,216
1334971980000000000,7,0,133,38,37,215
1334972040000000000,7,0,132,37,37,213
1334972100000000000,7,0,132,36,38,213
1334972160000000000,7,0,131,37,37,212
1334972220000000000,7,0,131,37,38,213
1334972280000000000,7,0,130,37,38,212
1334972340000000000,7,0,129,36,37,209
1334972400000000000,7,0,129,37,37,210
1334972460000000000,7,0,129,36,38,210
1334972520000000000,7,0,130,36,38,211
1334972580000000000,7,0,129,37,38,211
1334972640000000000,8,0,130,36,37,211
1334972700000000000,7,0,129,36,38,210
1334972760000000000,7,0,128,37,38,210
1334972820000000000,7,0,126,37,38,208
1334972880000000000,7,0,168,38,37,250
1334972940000000000,7,0,124,37,37,205
1334973000000000000,7,0,0,37,38,82
1334973060000000000,7,0,0,38,37,82
1334973120000000000,7,0,0,37,37,81
1334973180000000000,7,0,0,36,37,80
1334973240000000000,7,0,0,37,37,81
1334973300000000000,7,0,0,37,37,81
1334973360000000000,7,0,0,38,37,82
1334973420000000000,7,0,0,37,37,81
1334973480000000000,7,0,0,36,37,80
1334973540000000000,7,0,1,37,37,82
1334973600000000000,7,0,0,36,37,80
1334973660000000000,7,0,82,38,37,164
1334973720000000000,7,0,0,37,37,81
1334973780000000000,7,0,0,36,37,80
1334973840000000000,7,0,0,37,37,81
1334973900000000000,7,0,0,37,38,82
1334973960000000000,7,0,10,37,37,91
1334974020000000000,7,0,7,36,37,87
1334974080000000000,7,0,7,37,38,89
1334974140000000000,7,0,140,37,38,222
1334974200000000000,7,0,146,37,37,227
1334974260000000000,7,0,139,38,38,222
1334974320000000000,7,0,139,37,37,220
1334974380000000000,7,0,138,37,37,219
1334974440000000000,7,0,136,37,37,217
1334974500000000000,7,0,137,37,37,218
1334974560000000000,7,0,134,37,37,215
1334974620000000000,7,0,134,36,38,215
1334974680000000000,7,0,134,36,38,215
1334974740000000000,7,0,133,37,38,215
1334974800000000000,7,0,133,37,37,214
1334974860000000000,7,0,132,39,38,216
1334974920000000000,7,0,132,37,38,214
1334974980000000000,7,0,132,35,37,211
1334975040000000000,7,0,131,36,37,211
1334975100000000000,7,0,131,36,38,212
1334975160000000000,7,0,131,36,37,211
1334975220000000000,7,0,131,37,37,212
1334975280000000000,7,0,130,37,38,212
1334975340000000000,7,0,130,37,37,211
1334975400000000000,7,0,130,37,37,211
1334975460000000000,7,0,130,36,38,211
1334975520000000000,7,0,130,38,37,212
1334975580000000000,7,0,130,38,37,212
1334975640000000000,7,0,130,36,37,210
1334975700000000000,7,0,128,37,37,209
1334975760000000000,7,0,126,37,37,207
1334975820000000000,7,0,126,37,38,208
1334975880000000000,7,0,0,36,37,80
1334975940000000000,7,0,0,37,37,81
1334976000000000000,7,0,0,37,38,82
1334976060000000000,7,0,0,37,38,82
1334976120000000000,7,0,0,37,37,81
1334976180000000000,7,0,0,36,38,81
1334976240000000000,7,0,0,37,37,81
1334976300000000000,7,0,0,37,38,82
1334976360000000000,7,0,0,37,38,82
1334976420000000000,7,0,0,37,37,81
1334976480000000000,7,0,0,38,37,82
1334976540000000000,7,0,0,36,37,80
1334976600000000000,7,0,0,37,37,81
1334976660000000000,7,0,0,37,37,81
1334976720000000000,7,0,0,36,37,80
1334976780000000000,7,0,0,36,37,80
1334976840000000000,7,0,0,37,38,82
1334976900000000000,7,0,0,36,38,81
1334976960000000000,7,0,1,37,38,83
1334977020000000000,7,0,1,37,37,82
1334977080000000000,7,0,0,37,37,81
1334977140000000000,7,0,0,37,38,82
1334977200000000000,7,0,131,36,37,211
1334977260000000000,7,0,142,36,38,223
1334977320000000000,7,0,131,36,37,211
1334977380000000000,7,0,129,37,38,211
1334977440000000000,7,0,129,36,37,209
1334977500000000000,7,0,126,37,37,207
1334977560000000000,7,0,125,37,37,206
1334977620000000000,7,0,124,38,37,206
1334977680000000000,7,0,123,36,37,203
1334977740000000000,7,0,124,37,37,205
1334977800000000000,7,0,122,36,37,202
1334977860000000000,7,0,0,36,38,81
1334977920000000000,7,0,0,38,38,83
1334977980000000000,7,0,0,37,37,81
1334978040000000000,7,0,0,36,37,80
1334978100000000000,7,0,0,37,37,81
1334978160000000000,7,0,0,37,37,81
1334978220000000000,7,0,0,36,37,80
1334978280000000000,7,0,0,37,37,81
1334978340000000000,7,0,0,38,37,82
1334978400000000000,7,0,0,36,37,80
1334978460000000000,7,0,0,37,37,81
1334978520000000000,7,0,0,37,37,81
1334978580000000000,7,0,0,38,37,82
1334978640000000000,7,0,80,37,37,161
1334978700000000000,7,0,0,37,38,82
1334978760000000000,7,0,0,38,38,83
1334978820000000000,7,0,0,36,38,81
1334978880000000000,7,0,0,36,37,80
1334978940000000000,7,0,0,38,37,82
1334979000000000000,7,0,0,36,38,81
1334979060000000000,7,0,0,36,38,81
1334979120000000000,7,0,0,37,37,81
1334979180000000000,7,0,0,37,37,81
1334979240000000000,7,0,0,37,37,81
1334979300000000000,7,0,7,37,38,89
1334979360000000000,7,0,146,36,37,226
1334979420000000000,7,0,136,36,37,216
1334979480000000000,7,0,129,37,37,210
1334979540000000000,7,0,128,36,37,208
1334979600000000000,7,0,127,36,38,208
1334979660000000000,7,0,125,36,37,205
1334979720000000000,7,0,126,36,37,206
1334979780000000000,7,0,125,36,37,205
1334979840000000000,7,0,123,36,37,203
1334979900000000000,7,0,123,36,37,203
1334979960000000000,7,0,122,38,38,205
1334980020000000000,7,0,0,37,37,81
1334980080000000000,7,0,1,36,37,81
1334980140000000000,7,0,0,37,37,81
1334980200000000000,7,0,0,36,38,81
1334980260000000000,7,0,0,35,37,79
1334980320000000000,7,0,10,37,38,92
1334980380000000000,7,0,7,36,37,87
1334980440000000000,7,0,7,37,38,89
1334980500000000000,7,0,7,37,38,89
1334980560000000000,7,0,7,36,37,87
1334980620000000000,7,0,7,36,37,87
1334980680000000000,7,0,7,36,37,87
1334980740000000000,7,0,7,36,37,87
1334980800000000000,7,0,7,36,37,87
1334980860000000000,7,0,7,36,37,87
1334980920000000000,7,0,153,36,37,233
1334980980000000000,7,0,143,37,38,225
1334981040000000000,7,0,138,36,38,219
1334981100000000000,7,0,137,37,37,218
1334981160000000000,7,0,135,37,37,216
1334981220000000000,7,0,134,36,37,214
1334981280000000000,7,0,134,37,38,216
1334981340000000000,7,0,133,37,37,214
1334981400000000000,7,0,132,37,37,213
1334981460000000000,7,0,132,37,37,213
1334981520000000000,7,0,131,37,38,213
1334981580000000000,7,0,131,36,37,211
1334981640000000000,7,0,130,37,37,211
1334981700000000000,7,0,129,36,38,210
1334981760000000000,7,0,130,38,37,212
1334981820000000000,7,0,130,37,37,211
1334981880000000000,7,0,130,37,37,211
1334981940000000000,7,0,129,36,37,209
1334982000000000000,7,0,130,38,38,213
1334982060000000000,7,0,130,38,37,212
1334982120000000000,7,0,126,36,37,206
1334982180000000000,7,0,124,37,37,205
1334982240000000000,7,0,123,37,37,204
1334982300000000000,7,0,0,38,38,83
1334982360000000000,7,0,0,37,38,82
1334982420000000000,7,0,0,37,38,82
1334982480000000000,7,0,0,36,38,81
1334982540000000000,7,0,0,36,38,81
1334982600000000000,7,0,0,38,38,83
1334982660000000000,7,0,0,37,38,82
1334982720000000000,7,0,0,37,38,82
1334982780000000000,7,0,0,36,37,80
1334982840000000000,7,0,0,38,37,82
1334982900000000000,7,0,0,36,38,81
1334982960000000000,7,0,0,38,37,82
1334983020000000000,7,0,0,37,38,82
1334983080000000000,7,0,0,37,38,82
1334983140000000000,7,0,0,37,38,82
1334983200000000000,7,0,0,36,38,81
1334983260000000000,7,0,0,38,38,83
1334983320000000000,7,0,1,37,37,82
1334983380000000000,7,0,0,36,37,80
1334983440000000000,7,0,0,36,37,80
1334983500000000000,7,0,0,37,38,82
1334983560000000000,7,0,0,36,37,80
1334983620000000000,7,0,0,37,37,81
1334983680000000000,7,0,0,38,38,83
1334983740000000000,7,0,145,36,37,225
1334983800000000000,7,0,134,36,37,214
1334983860000000000,7,0,129,37,37,210
1334983920000000000,7,0,128,37,37,209
1334983980000000000,7,0,128,38,37,210
1334984040000000000,7,0,127,38,38,210
1334984100000000000,7,0,125,38,38,208
1334984160000000000,7,0,124,37,37,205
1334984220000000000,7,0,123,37,38,205
1334984280000000000,7,0,123,37,38,205
1334984340000000000,335,0,121,38,110,604
1334984400000000000,335,0,0,38,239,612
1334984460000000000,336,0,0,38,260,634
1334984520000000000,336,0,0,38,333,707
1334984580000000000,337,0,0,37,239,613
1334984640000000000,338,0,0,38,238,614
1334984700000000000,337,0,0,38,302,677
1334984760000000000,338,0,0,38,233,609
1334984820000000000,338,0,0,38,272,648
1334984880000000000,336,0,0,37,262,635
1334984940000000000,336,0,0,36,240,612
1334985000000000000,336,0,0,37,252,625
1334985060000000000,337,0,0,38,271,646
1334985120000000000,337,0,0,37,357,731
1334985180000000000,338,0,0,38,261,637
1334985240000000000,338,0,0,38,240,616
1334985300000000000,338,0,0,37,386,761
1334985360000000000,338,0,0,37,231,606
1334985420000000000,337,0,0,38,361,736
1334985480000000000,338,0,0,36,266,640
1334985540000000000,337,0,0,37,259,633
1334985600000000000,338,0,0,37,245,620
1334985660000000000,338,0,7,36,248,629
1334985720000000000,339,0,0,38,287,664
1334985780000000000,339,0,0,37,223,599
1334985840000000000,338,0,0,37,224,599
1334985900000000000,338,0,147,38,281,804
1334985960000000000,337,0,136,37,350,860
1334986020000000000,339,0,130,37,271,777
1334986080000000000,340,0,129,38,260,767
1334986140000000000,337,0,127,37,249,750
1334986200000000000,339,0,126,36,253,754
1334986260000000000,337,0,125,37,231,730
1334986320000000000,333,0,124,36,246,739
1334986380000000000,335,0,122,36,268,761
1334986440000000000,336,0,122,37,321,816
1334986500000000000,335,0,121,36,254,746
1334986560000000000,335,0,0,36,226,597
1334986620000000000,334,0,0,37,244,615
1334986680000000000,332,0,0,37,304,673
1334986740000000000,336,0,0,38,223,597
1334986800000000000,335,0,0,36,388,759
1334986860000000000,336,0,0,38,263,637
1334986920000000000,336,0,0,37,328,701
1334986980000000000,336,0,0,37,257,630
1334987040000000000,336,0,0,37,293,666
1334987100000000000,335,0,0,38,232,605
1334987160000000000,336,0,0,36,216,588
1334987220000000000,335,0,0,36,230,601
1334987280000000000,336,0,0,37,224,597
1334987340000000000,336,0,0,36,347,719
1334987400000000000,337,0,0,36,318,691
1334987460000000000,337,0,0,37,201,575
1334987520000000000,337,0,0,38,239,614
1334987580000000000,337,0,0,37,233,607
1334987640000000000,338,0,0,37,249,624
1334987700000000000,338,0,0,37,259,634
1334987760000000000,338,0,0,38,262,638
1334987820000000000,337,0,0,37,249,623
1334987880000000000,338,0,0,36,284,658
1334987940000000000,338,0,0,37,236,611
1334988000000000000,338,0,0,36,234,608
1334988060000000000,337,0,0,37,377,751
1334988120000000000,339,0,139,37,235,750
1334988180000000000,339,0,140,37,248,764
1334988240000000000,339,0,129,38,308,814
1334988300000000000,339,0,129,37,212,717
1334988360000000000,340,0,128,37,230,735
1334988420000000000,338,0,126,38,393,895
1334988480000000000,337,0,125,37,296,795
1334988540000000000,335,0,124,37,211,707
1334988600000000000,337,0,123,37,221,718
1334988660000000000,335,0,122,36,260,753
1334988720000000000,337,0,122,38,220,717
1334988780000000000,336,0,0,36,268,640
1334988840000000000,337,0,0,37,212,586
1334988900000000000,336,0,0,38,273,647
1334988960000000000,334,0,0,37,254,625
1334989020000000000,335,0,0,36,278,649
1334989080000000000,334,0,0,37,270,641
1334989140000000000,334,0,0,37,218,589
1334989200000000000,337,0,0,38,376,751
1334989260000000000,338,0,0,38,270,646
1334989320000000000,338,0,10,37,382,767
1334989380000000000,339,0,0,37,242,618
1334989440000000000,339,0,0,37,214,590
1334989500000000000,338,0,0,38,385,761
1334989560000000000,10,5,0,37,37,89
1334989620000000000,7,0,0,38,38,83
1334989680000000000,7,0,0,37,38,82
1334989740000000000,7,0,0,38,38,83
1334989800000000000,7,0,0,37,38,82
1334989860000000000,7,0,0,37,38,82
1334989920000000000,7,0,0,37,38,82
1334989980000000000,7,0,1,38,38,84
1334990040000000000,7,0,0,36,38,81
1334990100000000000,7,0,0,38,38,83
1334990160000000000,7,0,0,38,38,83
1334990220000000000,7,0,147,37,38,229
1334990280000000000,7,0,139,38,38,222
1334990340000000000,7,0,136,36,38,217
1334990400000000000,7,0,134,37,38,216
1334990460000000000,7,0,133,37,37,214
1334990520000000000,7,0,132,36,38,213
1334990580000000000,7,0,132,37,37,213
1334990640000000000,7,0,132,36,38,213
1334990700000000000,7,0,132,36,38,213
1334990760000000000,7,0,130,38,38,213
1334990820000000000,7,0,130,36,39,212
1334990880000000000,7,0,130,36,38,211
1334990940000000000,7,0,129,37,38,211
1334991000000000000,7,0,129,37,38,211
1334991060000000000,7,0,130,37,38,212
1334991120000000000,7,0,129,37,38,211
1334991180000000000,7,0,130,37,39,213
1334991240000000000,7,0,129,37,38,211
1334991300000000000,7,0,129,37,38,211
1334991360000000000,7,0,128,38,38,211
1334991420000000000,7,0,129,37,38,211
1334991480000000000,7,0,7,36,38,88
1334991540000000000,7,0,7,36,38,88
1334991600000000000,7,0,7,37,38,89
1334991660000000000,7,0,7,37,38,89
1334991720000000000,7,0,7,37,38,89
1334991780000000000,7,0,10,37,38,92
1334991840000000000,7,0,0,38,38,83
1334991900000000000,7,0,0,38,38,83
1334991960000000000,7,0,0,38,38,83
1334992020000000000,7,0,0,37,37,81
1334992080000000000,7,0,151,38,38,234
1334992140000000000,7,0,136,38,37,218
1334992200000000000,7,0,131,37,38,213
1334992260000000000,7,0,129,38,38,212
1334992320000000000,7,0,129,38,38,212
1334992380000000000,7,0,127,37,38,209
1334992440000000000,7,0,126,37,38,208
1334992500000000000,7,0,124,37,38,206
1334992560000000000,7,0,124,37,38,206
1334992620000000000,7,0,123,36,38,204
1334992680000000000,7,0,122,37,38,204
1334992740000000000,7,0,1,38,38,84
1334992800000000000,7,0,0,37,38,82
1334992860000000000,7,0,0,38,38,83
1334992920000000000,7,0,0,38,39,84
1334992980000000000,7,0,0,38,38,83
1334993040000000000,7,0,0,37,38,82
1334993100000000000,7,0,0,37,38,82
1334993160000000000,7,0,1,38,38,84
1334993220000000000,7,0,0,38,38,83
1334993280000000000,7,0,0,38,38,83
1334993340000000000,7,0,0,38,38,83
1334993400000000000,7,0,0,38,38,83
1334993460000000000,7,0,0,38,38,83
1334993520000000000,7,0,0,38,38,83
1334993580000000000,7,0,1,38,38,84
1334993640000000000,7,0,0,38,38,83
1334993700000000000,7,0,1,37,38,83
1334993760000000000,7,0,0,37,38,82
1334993820000000000,7,0,0,37,38,82
1334993880000000000,7,0,0,37,37,81
1334993940000000000,7,0,0,37,38,82
1334994000000000000,7,0,1,37,38,83
1334994060000000000,7,0,0,38,38,83
1334994120000000000,7,0,0,37,38,82
1334994180000000000,7,0,0,38,38,83
1334994240000000000,7,0,0,38,38,83
1334994300000000000,7,0,0,37,38,82
1334994360000000000,7,0,0,37,38,82
1334994420000000000,7,0,143,36,38,224
1334994480000000000,7,0,132,38,38,215
1334994540000000000,7,0,128,37,37,209
1334994600000000000,7,0,127,38,39,211
1334994660000000000,7,0,126,38,37,208
1334994720000000000,7,0,125,37,38,207
1334994780000000000,7,0,125,38,38,208
1334994840000000000,7,0,124,38,38,207
1334994900000000000,7,0,123,38,39,207
1334994960000000000,7,0,123,37,38,205
1334995020000000000,7,0,1,37,38,83
1334995080000000000,7,0,1,38,38,84
1334995140000000000,7,0,0,38,39,84
1334995200000000000,7,0,0,38,39,84
1334995260000000000,7,0,0,38,38,83
1334995320000000000,7,0,1,38,38,84
1334995380000000000,7,0,10,37,38,92
1334995440000000000,7,0,7,38,38,90
1334995500000000000,7,0,0,38,38,83
1334995560000000000,7,0,0,37,38,82
1334995620000000000,7,0,1,37,39,84
1334995680000000000,7,0,0,38,38,83
1334995740000000000,7,0,0,39,38,84
1334995800000000000,7,0,0,38,38,83
1334995860000000000,7,0,0,38,38,83
1334995920000000000,7,0,0,38,38,83
1334995980000000000,7,0,0,38,38,83
1334996040000000000,7,0,0,38,37,82
1334996100000000000,7,0,0,38,38,83
1334996160000000000,7,0,0,38,38,83
1334996220000000000,7,0,0,38,38,83
1334996280000000000,7,0,0,38,38,83
1334996340000000000,7,0,0,38,38,83
1334996400000000000,7,0,0,38,38,83
1334996460000000000,7,0,0,38,38,83
1334996520000000000,7,0,142,38,39,226
1334996580000000000,7,0,141,38,38,224
1334996640000000000,7,0,132,38,38,215
1334996700000000000,7,0,129,38,38,212
1334996760000000000,7,0,127,38,38,210
1334996820000000000,7,0,126,37,38,208
1334996880000000000,7,0,126,37,38,208
1334996940000000000,7,0,125,38,38,208
1334997000000000000,7,0,123,38,39,207
1334997060000000000,7,0,123,38,38,206
1334997120000000000,7,0,122,38,37,204
1334997180000000000,7,0,1,37,38,83
1334997240000000000,7,0,0,37,38,82
1334997300000000000,7,0,0,38,39,84
1334997360000000000,7,0,0,39,38,84
1334997420000000000,7,0,0,38,38,83
1334997480000000000,7,0,0,38,38,83
1334997540000000000,7,0,0,38,39,84
1334997600000000000,7,0,1,38,39,85
1334997660000000000,7,0,0,38,38,83
1334997720000000000,7,0,0,37,38,82
1334997780000000000,7,0,0,37,38,82
1334997840000000000,7,0,1,38,38,84
1334997900000000000,7,0,0,37,38,82
1334997960000000000,7,0,1,38,38,84
1334998020000000000,7,0,0,38,39,84
1334998080000000000,7,0,0,39,38,84
1334998140000000000,7,0,1,37,38,83
1334998200000000000,7,0,0,38,38,83
1334998260000000000,7,0,0,38,38,83
1334998320000000000,7,0,0,37,38,82
1334998380000000000,7,0,1,39,39,86
1334998440000000000,7,0,1,37,38,83
1334998500000000000,7,0,0,38,39,84
1334998560000000000,7,0,0,38,39,84
1334998620000000000,7,0,0,38,38,83
1334998680000000000,7,0,0,38,38,83
1334998740000000000,7,0,0,38,38,83
1334998800000000000,7,0,0,38,38,83
1334998860000000000,7,0,0,38,39,84
1334998920000000000,7,0,138,37,38,220
1334998980000000000,7,0,141,37,38,223
1334999040000000000,7,0,132,39,38,216
1334999100000000000,7,0,130,38,38,213
1334999160000000000,7,0,128,38,38,211
1334999220000000000,7,0,127,37,38,209
1334999280000000000,8,0,127,39,38,212
1334999340000000000,7,0,126,38,38,209
1334999400000000000,7,0,125,38,38,208
1334999460000000000,7,0,123,38,38,206
1334999520000000000,7,0,123,37,38,205
1334999580000000000,7,0,0,805,39,851
1334999640000000000,7,0,1,1620,38,1666
1334999700000000000,7,0,0,1654,38,1699
1334999760000000000,7,0,0,1707,39,1753
1334999820000000000,7,0,0,1742,38,1787
1334999880000000000,7,0,0,1754,38,1799
1334999940000000000,7,0,0,1763,38,1808
1335000000000000000,7,0,0,1737,38,1782
1335000060000000000,7,0,0,1743,38,1788
1335000120000000000,7,0,0,1751,38,1796
1335000180000000000,7,0,0,1758,38,1803
1335000240000000000,7,0,1,1760,38,1806
1335000300000000000,7,0,0,1761,39,1807
1335000360000000000,7,0,0,1767,38,1812
1335000420000000000,7,0,0,1761,38,1806
1335000480000000000,7,0,0,1774,38,1819
1335000540000000000,7,0,1,1778,38,1824
1335000600000000000,7,0,0,1771,38,1816
1335000660000000000,7,0,0,1775,39,1821
1335000720000000000,7,0,0,1779,38,1824
1335000780000000000,7,0,0,1777,38,1822
1335000840000000000,7,0,0,1782,38,1827
1335000900000000000,7,0,0,1781,39,1827
1335000960000000000,7,0,0,1789,39,1835
1335001020000000000,7,0,0,1784,38,1829
1335001080000000000,7,0,0,1791,38,1836
1335001140000000000,7,0,0,1787,38,1832
1335001200000000000,7,0,0,1,38,46
1335001260000000000,7,0,0,1,38,46
1335001320000000000,7,0,1,1,38,47
1335001380000000000,7,0,147,1,38,193
1335001440000000000,7,0,137,1,37,182
1335001500000000000,7,0,130,1,38,176
1335001560000000000,7,0,132,1,40,180
1335001620000000000,7,0,130,1,38,176
1335001680000000000,7,0,132,1,38,178
1335001740000000000,7,0,133,1,38,179
1335001800000000000,7,0,131,1,38,177
1335001860000000000,7,0,131,1,38,177
1335001920000000000,7,0,130,1,38,176
1335001980000000000,7,0,130,1,38,176
1335002040000000000,7,0,129,1,37,174
1335002100000000000,7,0,129,1,38,175
1335002160000000000,7,0,129,41,38,215
1335002220000000000,7,0,129,41,38,215
1335002280000000000,7,0,129,41,38,215
1335002340000000000,7,0,129,38,38,212
1335002400000000000,7,0,7,39,39,92
1335002460000000000,7,0,7,38,38,90
1335002520000000000,7,0,7,38,38,90
1335002580000000000,7,0,8,38,38,91
1335002640000000000,7,0,7,38,38,90
1335002700000000000,7,0,7,39,38,91
1335002760000000000,7,0,7,38,38,90
1335002820000000000,7,0,7,38,38,90
1335002880000000000,7,0,7,38,38,90
1335002940000000000,7,0,7,38,38,90
1335003000000000000,7,0,150,38,38,233
1335003060000000000,7,0,141,38,38,224
1335003120000000000,7,0,136,38,38,219
1335003180000000000,7,0,134,38,38,217
1335003240000000000,7,0,132,38,38,215
1335003300000000000,7,0,131,38,38,214
1335003360000000000,7,0,129,38,38,212
1335003420000000000,7,0,127,38,38,210
1335003480000000000,7,0,126,38,38,209
1335003540000000000,7,0,125,38,38,208
1335003600000000000,7,0,125,38,38,208
1335003660000000000,7,0,124,39,38,208
1335003720000000000,7,0,125,39,38,209
1335003780000000000,7,0,0,38,38,83
1335003840000000000,7,0,0,38,38,83
1335003900000000000,7,0,0,37,38,82
1335003960000000000,7,0,1,38,38,84
1335004020000000000,7,0,0,38,38,83
1335004080000000000,7,0,0,38,38,83
1335004140000000000,7,0,1,39,38,85
1335004200000000000,7,0,0,39,38,84
1335004260000000000,7,0,0,37,38,82
1335004320000000000,7,0,0,37,39,83
1335004380000000000,7,0,0,38,39,84
1335004440000000000,7,0,0,39,38,84
1335004500000000000,7,0,1,38,38,84
1335004560000000000,7,0,1,38,39,85
1335004620000000000,7,0,0,39,38,84
1335004680000000000,7,0,0,39,38,84
1335004740000000000,7,0,0,39,38,84
1335004800000000000,7,0,0,38,38,83
1335004860000000000,7,0,0,38,38,83
1335004920000000000,7,0,0,1342,37,1386
1335004980000000000,7,0,0,1610,38,1655
1335005040000000000,7,0,0,1709,38,1754
1335005100000000000,7,0,0,1738,38,1783
1335005160000000000,7,0,0,1753,38,1798
1335005220000000000,7,0,0,1769,38,1814
1335005280000000000,7,0,0,1763,37,1807
1335005340000000000,7,0,0,1746,38,1791
1335005400000000000,7,0,0,1747,38,1792
1335005460000000000,7,0,0,1745,38,1790
1335005520000000000,7,0,142,1757,37,1943
1335005580000000000,7,0,132,1765,38,1942
1335005640000000000,7,0,128,1767,38,1940
1335005700000000000,7,0,127,1766,38,1938
1335005760000000000,7,0,127,1768,38,1940
1335005820000000000,7,0,126,1769,39,1941
1335005880000000000,7,0,124,1777,39,1947
1335005940000000000,7,0,124,1777,38,1946
1335006000000000000,7,0,124,1782,38,1951
1335006060000000000,7,0,123,1779,38,1947
1335006120000000000,7,0,0,1773,38,1818
1335006180000000000,7,0,0,1785,39,1831
1335006240000000000,7,0,0,1789,38,1834
1335006300000000000,7,0,0,1787,38,1832
1335006360000000000,7,0,1,1791,38,1837
1335006420000000000,7,0,0,1783,38,1828
1335006480000000000,7,0,0,1794,38,1839
1335006540000000000,7,0,0,1778,37,1822
1335006600000000000,7,0,0,1799,38,1844
1335006660000000000,7,0,0,1795,39,1841
1335006720000000000,7,0,1,1781,38,1827
1335006780000000000,7,0,10,1797,37,1851
1335006840000000000,7,0,0,1,38,46
1335006900000000000,7,0,0,1,38,46
1335006960000000000,7,0,0,1,38,46
1335007020000000000,7,0,0,1,38,46
1335007080000000000,7,0,0,1,38,46
1335007140000000000,7,0,0,0,37,44
1335007200000000000,7,0,0,1,38,46
1335007260000000000,7,0,0,1,38,46
1335007320000000000,7,0,0,1,38,46
1335007380000000000,7,0,0,1,37,45
1335007440000000000,7,0,0,1,38,46
1335007500000000000,7,0,0,0,38,45
1335007560000000000,7,0,0,1,38,46
1335007620000000000,7,0,0,1,38,46
1335007680000000000,7,0,0,1,38,46
1335007740000000000,7,0,0,1,38,46
1335007800000000000,7,0,146,39,38,230
1335007860000000000,7,0,133,39,39,218
1335007920000000000,7,0,131,38,37,213
1335007980000000000,7,0,130,37,38,212
1335008040000000000,7,0,127,37,38,209
1335008100000000000,7,0,126,38,39,210
1335008160000000000,7,0,125,38,39,209
1335008220000000000,7,0,124,39,38,208
1335008280000000000,7,0,123,37,38,205
1335008340000000000,7,0,122,37,39,205
1335008400000000000,7,0,1,38,38,84
1335008460000000000,7,0,1,38,38,84
1335008520000000000,7,0,0,38,38,83
1335008580000000000,7,0,0,38,38,83
1335008640000000000,7,0,0,37,38,82
1335008700000000000,7,0,0,39,38,84
1335008760000000000,7,0,0,38,38,83
1335008820000000000,7,0,0,38,38,83
1335008880000000000,7,0,0,38,38,83
1335008940000000000,7,0,1,37,38,83
1335009000000000000,7,0,1,38,38,84
1335009060000000000,7,0,0,38,38,83
1335009120000000000,7,0,0,38,38,83
1335009180000000000,7,0,0,38,38,83
1335009240000000000,7,0,0,37,38,82
1335009300000000000,7,0,0,38,39,84
1335009360000000000,7,0,0,38,38,83
1335009420000000000,7,0,1,38,38,84
1335009480000000000,7,0,0,37,38,82
1335009540000000000,7,0,0,38,38,83
1335009600000000000,7,0,0,1281,38,1326
1335009660000000000,7,0,0,1597,38,1642
1335009720000000000,7,0,0,1704,38,1749
1335009780000000000,7,0,1,1736,39,1783
1335009840000000000,7,0,0,1750,38,1795
1335009900000000000,7,0,1,1766,38,1812
1335009960000000000,7,0,0,1770,38,1815
1335010020000000000,7,0,1,1775,38,1821
1335010080000000000,7,0,0,1751,38,1796
1335010140000000000,7,0,0,1758,38,1803
1335010200000000000,7,0,0,1767,38,1812
1335010260000000000,7,0,0,1747,38,1792
1335010320000000000,7,0,0,1763,38,1808
1335010380000000000,7,0,144,1778,37,1966
1335010440000000000,7,0,143,1769,38,1957
1335010500000000000,7,0,133,1773,38,1951
1335010560000000000,7,0,129,1769,38,1943
1335010620000000000,7,0,127,1776,38,1948
1335010680000000000,7,0,127,1779,38,1951
1335010740000000000,7,0,126,1785,38,1956
1335010800000000000,7,0,125,1791,38,1961
1335010860000000000,7,0,124,1784,38,1953
1335010920000000000,7,0,123,1781,38,1949
1335010980000000000,7,0,122,1787,38,1954
1335011040000000000,7,0,0,1790,38,1835
1335011100000000000,7,0,0,1786,38,1831
1335011160000000000,7,0,0,1790,38,1835
1335011220000000000,7,0,1,1799,38,1845
1335011280000000000,7,0,0,1792,38,1837
1335011340000000000,7,0,0,1790,38,1835
1335011400000000000,7,0,0,1789,38,1834
1335011460000000000,7,0,1,1798,38,1844
1335011520000000000,7,0,0,1797,39,1843
1335011580000000000,7,0,0,1798,38,1843
1335011640000000000,7,0,0,1795,38,1840
1335011700000000000,7,0,0,1795,38,1840
1335011760000000000,7,0,0,1,38,46
1335011820000000000,7,0,1,1,38,47
1335011880000000000,7,0,0,0,38,45
1335011940000000000,7,0,0,1,38,46
1335012000000000000,7,0,0,1,39,47
1335012060000000000,7,0,0,1,38,46
1335012120000000000,7,0,0,1,38,46
1335012180000000000,7,0,0,1,38,46
1335012240000000000,7,0,0,1,38,46
1335012300000000000,7,0,0,1,38,46
1335012360000000000,7,0,1,1,38,47
1335012420000000000,7,0,0,1,38,46
1335012480000000000,7,0,0,1,41,49
1335012540000000000,7,0,0,1,38,46
1335012600000000000,7,0,0,1,38,46
1335012660000000000,7,0,0,0,38,45
1335012720000000000,7,0,0,1,38,46
1335012780000000000,7,0,0,39,38,84
1335012840000000000,7,0,0,41,38,86
1335012900000000000,7,0,0,38,37,82
1335012960000000000,7,0,0,37,38,82
1335013020000000000,7,0,148,37,38,230
1335013080000000000,7,0,137,38,38,220
1335013140000000000,7,0,134,37,38,216
1335013200000000000,7,0,133,38,38,216
1335013260000000000,7,0,132,38,38,215
1335013320000000000,7,0,132,37,38,214
1335013380000000000,7,0,131,38,38,214
1335013440000000000,7,0,131,37,38,213
1335013500000000000,7,0,130,37,38,212
1335013560000000000,7,0,130,38,38,213
1335013620000000000,7,0,130,38,39,214
1335013680000000000,7,0,131,37,38,213
1335013740000000000,7,0,129,37,38,211
1335013800000000000,7,0,128,37,37,209
1335013860000000000,7,0,130,38,39,214
1335013920000000000,7,0,130,38,38,213
1335013980000000000,7,0,128,38,38,211
1335014040000000000,7,0,128,38,38,211
1335014100000000000,7,0,99,1429,38,1573
1335014160000000000,7,0,7,1649,38,1701
1335014220000000000,7,0,7,1722,38,1774
1335014280000000000,7,0,7,1742,38,1794
1335014340000000000,7,0,7,1759,38,1811
1335014400000000000,7,0,7,1760,38,1812
1335014460000000000,7,0,7,1750,38,1802
1335014520000000000,7,0,7,1751,38,1803
1335014580000000000,7,0,7,1759,38,1811
1335014640000000000,7,0,9,1759,38,1813
1335014700000000000,7,0,1129,1761,38,2935
1335014760000000000,7,0,147,1774,38,1966
1335014820000000000,7,0,134,1770,38,1949
1335014880000000000,7,0,131,1778,38,1954
1335014940000000000,7,0,131,1782,38,1958
1335015000000000000,7,0,129,1781,38,1955
1335015060000000000,7,0,127,1786,37,1957
1335015120000000000,7,0,127,1789,38,1961
1335015180000000000,7,0,125,1786,38,1956
1335015240000000000,7,0,126,1789,38,1960
1335015300000000000,7,0,124,1789,38,1958
1335015360000000000,7,0,122,1793,38,1960
1335015420000000000,7,0,0,1794,38,1839
1335015480000000000,7,0,0,1793,38,1838
1335015540000000000,7,0,0,1793,38,1838
1335015600000000000,7,0,0,1795,39,1841
1335015660000000000,7,0,0,1798,38,1843
1335015720000000000,7,0,0,1800,38,1845
1335015780000000000,7,0,0,1801,38,1846
1335015840000000000,7,0,0,1799,38,1844
1335015900000000000,7,0,0,1798,38,1843
1335015960000000000,7,0,1,1,38,47
1335016020000000000,7,0,0,1,38,46
1335016080000000000,7,0,0,1,38,46
1335016140000000000,7,0,0,1,38,46
1335016200000000000,7,0,0,1,38,46
1335016260000000000,7,0,0,1,37,45
1335016320000000000,7,0,0,1,38,46
1335016380000000000,7,0,0,1,38,46
1335016440000000000,7,0,1,1,38,47
1335016500000000000,7,0,0,1,38,46
1335016560000000000,7,0,1,1,38,47
1335016620000000000,7,0,1,1,38,47
1335016680000000000,7,0,0,0,38,45
1335016740000000000,7,0,0,1,38,46
1335016800000000000,7,0,0,1,38,46
1335016860000000000,7,0,1,0,38,46
1335016920000000000,7,0,1,0,37,45
1335016980000000000,7,0,1,42,38,88
1335017040000000000,7,0,0,38,38,83
1335017100000000000,7,0,0,38,38,83
1335017160000000000,7,0,0,38,38,83
1335017220000000000,7,0,1,36,38,82
1335017280000000000,7,0,0,37,38,82
1335017340000000000,7,0,0,37,38,82
1335017400000000000,7,0,145,38,38,228
1335017460000000000,7,0,136,36,38,217
1335017520000000000,7,0,128,37,38,210
1335017580000000000,7,0,128,36,38,209
1335017640000000000,7,0,126,38,38,209
1335017700000000000,7,0,126,37,38,208
1335017760000000000,7,0,124,38,38,207
1335017820000000000,7,0,124,37,38,206
1335017880000000000,7,0,123,38,39,207
1335017940000000000,7,0,122,37,39,205
1335018000000000000,7,0,77,37,38,159
1335018060000000000,7,0,0,38,37,82
1335018120000000000,7,0,0,36,38,81
1335018180000000000,7,0,0,36,38,81
1335018240000000000,7,0,0,37,38,82
1335018300000000000,7,0,10,36,38,91
1335018360000000000,7,0,1,38,38,84
1335018420000000000,7,0,0,36,38,81
1335018480000000000,7,0,0,37,38,82
1335018540000000000,7,0,0,37,38,82
1335018600000000000,7,0,0,37,38,82
1335018660000000000,7,0,0,38,39,84
1335018720000000000,7,0,0,1535,38,1580
1335018780000000000,7,0,0,1691,38,1736
1335018840000000000,7,0,0,1733,38,1778
1335018900000000000,7,0,0,1752,37,1796
1335018960000000000,7,0,1,1775,39,1822
1335019020000000000,7,0,0,1779,38,1824
1335019080000000000,7,0,0,1761,38,1806
1335019140000000000,7,0,0,1762,38,1807
1335019200000000000,7,0,0,1770,38,1815
1335019260000000000,7,0,0,1770,38,1815
1335019320000000000,7,0,0,1776,38,1821
1335019380000000000,7,0,0,1776,38,1821
1335019440000000000,7,0,0,1783,38,1828
1335019500000000000,7,0,0,1786,38,1831
1335019560000000000,7,0,1,1791,37,1836
1335019620000000000,7,0,0,1795,38,1840
1335019680000000000,7,0,0,1789,38,1834
1335019740000000000,7,0,0,1793,38,1838
1335019800000000000,7,0,0,1789,38,1834
1335019860000000000,7,0,145,1794,38,1984
1335019920000000000,7,0,132,1797,38,1974
1335019980000000000,7,0,129,1805,37,1978
1335020040000000000,7,0,127,1802,37,1973
1335020100000000000,7,0,126,1794,38,1965
1335020160000000000,7,0,124,1798,38,1967
1335020220000000000,7,0,123,1799,38,1967
1335020280000000000,7,0,122,1802,38,1969
1335020340000000000,7,0,122,1805,38,1972
1335020400000000000,7,0,122,1811,38,1978
1335020460000000000,7,0,1,0,38,46
1335020520000000000,7,0,0,1,37,45
1335020580000000000,7,0,0,1,38,46
1335020640000000000,7,0,0,1,38,46
1335020700000000000,7,0,0,1,38,46
1335020760000000000,7,0,0,1,38,46
1335020820000000000,7,0,0,1,38,46
1335020880000000000,7,0,0,1,38,46
1335020940000000000,7,0,0,1,38,46
1335021000000000000,7,0,1,1,38,47
1335021060000000000,7,0,0,1,38,46
1335021120000000000,7,0,0,1,38,46
1335021180000000000,7,0,0,1,38,46
1335021240000000000,7,0,0,1,38,46
1335021300000000000,7,0,0,1,38,46
1335021360000000000,7,0,0,1,38,46
1335021420000000000,7,0,0,1,38,46
1335021480000000000,7,0,0,1,37,45
1335021540000000000,7,0,0,39,38,84
1335021600000000000,7,0,0,38,37,82
1335021660000000000,7,0,0,37,38,82
1335021720000000000,7,0,1,37,38,83
1335021780000000000,7,0,0,37,37,81
1335021840000000000,7,0,0,38,38,83
1335021900000000000,7,0,10,38,37,92
1335021960000000000,7,0,7,38,38,90
1335022020000000000,7,0,7,37,38,89
1335022080000000000,7,0,7,36,38,88
1335022140000000000,7,0,7,36,38,88
1335022200000000000,7,0,154,36,38,235
1335022260000000000,7,0,140,36,38,221
1335022320000000000,7,0,136,36,38,217
1335022380000000000,7,0,135,37,38,217
1335022440000000000,7,0,134,36,37,214
1335022500000000000,7,0,132,37,37,213
1335022560000000000,7,0,132,36,37,212
1335022620000000000,7,0,132,37,38,214
1335022680000000000,7,0,131,36,38,212
1335022740000000000,7,0,131,36,38,212
1335022800000000000,7,0,129,36,38,210
1335022860000000000,7,0,129,36,38,210
1335022920000000000,7,0,129,37,38,211
1335022980000000000,7,0,129,36,38,210
1335023040000000000,7,0,129,37,37,210
1335023100000000000,7,0,128,36,38,209
1335023160000000000,7,0,127,36,38,208
1335023220000000000,7,0,127,36,38,208
1335023280000000000,7,0,127,36,38,208
1335023340000000000,7,0,127,36,38,208
1335023400000000000,7,0,127,36,38,208
1335023460000000000,7,0,7,35,38,87
1335023520000000000,7,0,7,36,38,88
1335023580000000000,7,0,0,35,39,81
1335023640000000000,7,0,0,36,37,80
1335023700000000000,7,0,0,36,38,81
1335023760000000000,7,0,0,36,37,80
1335023820000000000,7,0,0,36,38,81
1335023880000000000,7,0,0,36,38,81
1335023940000000000,7,0,0,37,38,82
1335024000000000000,7,0,0,37,38,82
1335024060000000000,7,0,0,37,37,81
1335024120000000000,7,0,0,37,38,82
1335024180000000000,7,0,0,36,38,81
1335024240000000000,7,0,0,36,38,81
1335024300000000000,7,0,0,37,38,82
1335024360000000000,7,10,0,36,37,90
1335024420000000000,7,10,143,36,37,233
1335024480000000000,7,12,130,36,37,222
1335024540000000000,7,6,128,37,38,216
1335024600000000000,7,11,125,34,38,215
1335024660000000000,7,4,125,36,38,210
1335024720000000000,7,6,124,37,37,211
1335024780000000000,7,5,123,37,37,209
1335024840000000000,7,7,122,36,37,209
1335024900000000000,7,9,121,36,38,211
1335024960000000000,7,6,121,1406,38,1578
1335025020000000000,7,9,0,1650,38,1704
1335025080000000000,7,5,0,1738,38,1788
1335025140000000000,7,6,0,1765,38,1816
1335025200000000000,7,9,0,1777,37,1830
1335025260000000000,7,10,0,1792,38,1847
1335025320000000000,7,7,0,1766,37,1817
1335025380000000000,7,5,0,1776,38,1826
1335025440000000000,7,11,0,1781,38,1837
1335025500000000000,7,6,0,1797,38,1848
1335025560000000000,7,6,0,1791,38,1842
1335025620000000000,7,7,0,1807,38,1859
1335025680000000000,7,10,0,1794,38,1849
1335025740000000000,7,9,0,1806,39,1861
1335025800000000000,7,9,0,1811,38,1865
1335025860000000000,7,9,0,1811,38,1865
1335025920000000000,7,7,0,1827,38,1879
1335025980000000000,7,5,0,1814,38,1864
1335026040000000000,7,5,0,1824,38,1874
1335026100000000000,7,7,0,1829,38,1881
1335026160000000000,7,7,0,0,38,52
1335026220000000000,7,7,0,1,38,53
1335026280000000000,7,9,0,1,38,55
1335026340000000000,7,5,0,1,38,51
1335026400000000000,7,5,0,1,38,51
1335026460000000000,7,6,0,1,38,52
1335026520000000000,7,9,0,1,38,55
1335026580000000000,7,10,0,1,38,56
1335026640000000000,7,10,0,1,38,56
1335026700000000000,7,5,0,1,38,51
1335026760000000000,7,9,0,1,38,55
1335026820000000000,7,9,0,1,38,55
1335026880000000000,7,10,0,1,38,56
1335026940000000000,7,11,0,0,38,56
1335027000000000000,7,5,0,1,38,51
1335027060000000000,7,9,0,1,38,55
1335027120000000000,7,5,0,1,38,51
1335027180000000000,7,5,10,1,38,61
1335027240000000000,7,5,147,1,38,198
1335027300000000000,7,9,135,1,38,190
1335027360000000000,7,5,131,1,38,182
1335027420000000000,7,7,128,1,38,181
1335027480000000000,7,7,126,41,38,219
1335027540000000000,7,11,125,38,38,219
1335027600000000000,7,7,125,37,38,214
1335027660000000000,7,7,125,38,38,215
1335027720000000000,7,9,123,36,38,213
1335027780000000000,7,4,122,37,38,208
1335027840000000000,7,5,123,36,38,209
1335027900000000000,7,9,123,38,39,216
1335027960000000000,7,5,121,37,38,208
1335028020000000000,7,7,0,36,38,88
1335028080000000000,7,6,0,37,38,88
1335028140000000000,7,7,0,36,38,88
1335028200000000000,7,9,0,36,38,90
1335028260000000000,7,6,452,35,38,538
1335028320000000000,7,7,443,37,37,531
1335028380000000000,7,7,436,37,38,525
1335028440000000000,7,6,432,36,38,519
1335028500000000000,7,7,432,36,38,520
1335028560000000000,7,6,432,37,37,519
1335028620000000000,7,6,433,35,38,519
1335028680000000000,7,6,433,36,38,520
1335028740000000000,7,5,436,36,38,522
1335028800000000000,7,10,441,36,38,532
1335028860000000000,7,11,439,36,38,531
1335028920000000000,7,6,440,36,39,528
1335028980000000000,7,7,439,36,38,527
1335029040000000000,7,7,439,36,38,527
1335029100000000000,7,6,439,37,38,527
1335029160000000000,7,9,440,36,38,530
1335029220000000000,7,5,439,36,38,525
1335029280000000000,7,6,1,36,38,88
1335029340000000000,7,7,1,36,39,90
1335029400000000000,7,6,1,36,38,88
1335029460000000000,7,5,1,38,39,90
1335029520000000000,7,10,209,37,38,301
1335029580000000000,7,11,154,38,38,248
1335029640000000000,7,9,154,36,38,244
1335029700000000000,7,5,156,37,38,243
1335029760000000000,7,6,155,36,38,242
1335029820000000000,7,6,149,37,37,236
1335029880000000000,7,9,146,36,38,236
1335029940000000000,7,10,144,37,38,236
1335030000000000000,7,4,143,36,38,228
1335030060000000000,7,6,143,37,38,231
1335030120000000000,7,9,142,35,38,231
1335030180000000000,7,6,141,37,38,229
1335030240000000000,7,5,140,36,38,226
1335030300000000000,7,6,139,37,38,227
1335030360000000000,7,10,138,36,38,229
1335030420000000000,7,9,138,36,38,228
1335030480000000000,7,9,137,36,38,227
1335030540000000000,7,10,136,37,38,228
1335030600000000000,7,7,135,36,38,223
1335030660000000000,7,6,135,36,37,221
1335030720000000000,7,5,135,36,38,221
1335030780000000000,7,7,134,36,38,222
1335030840000000000,7,9,134,36,38,224
1335030900000000000,7,6,134,36,38,221
1335030960000000000,7,4,134,37,38,220
1335031020000000000,7,9,133,37,38,224
1335031080000000000,7,11,133,38,38,227
1335031140000000000,7,5,133,36,38,219
1335031200000000000,7,7,132,36,38,220
1335031260000000000,7,9,132,38,37,223
1335031320000000000,7,10,132,37,38,224
1335031380000000000,7,5,130,37,40,219
1335031440000000000,7,10,127,38,38,220
1335031500000000000,7,5,126,36,38,212
1335031560000000000,7,10,125,37,38,217
1335031620000000000,7,11,125,35,38,216
1335031680000000000,7,5,123,36,38,209
1335031740000000000,7,5,122,37,38,209
1335031800000000000,7,10,0,38,37,92
1335031860000000000,7,5,0,36,38,86
1335031920000000000,7,10,0,35,38,90
1335031980000000000,7,10,0,37,37,91
1335032040000000000,7,10,0,37,38,92
1335032100000000000,7,6,0,37,37,87
1335032160000000000,7,9,1,37,38,92
1335032220000000000,7,5,0,37,37,86
1335032280000000000,7,5,0,38,39,89
1335032340000000000,7,11,0,38,38,94
1335032400000000000,7,10,0,38,39,94
1335032460000000000,7,10,0,36,39,92
1335032520000000000,7,6,0,37,38,88
1335032580000000000,7,9,0,36,38,90
1335032640000000000,7,10,0,37,37,91
1335032700000000000,7,5,0,36,37,85
1335032760000000000,7,6,0,36,38,87
1335032820000000000,7,9,0,36,39,91
1335032880000000000,7,9,0,36,38,90
1335032940000000000,7,10,0,37,38,92
1335033000000000000,7,6,1,36,38,88
1335033060000000000,7,5,0,36,37,85
1335033120000000000,7,6,0,37,37,87
1335033180000000000,7,10,1,36,38,92
1335033240000000000,7,10,139,37,38,231
1335033300000000000,7,7,138,36,38,226
1335033360000000000,7,11,128,36,38,220
1335033420000000000,7,6,127,37,38,215
1335033480000000000,7,6,126,37,38,214
1335033540000000000,7,6,126,36,39,214
1335033600000000000,7,10,124,37,38,216
1335033660000000000,7,5,124,36,38,210
1335033720000000000,7,5,125,37,38,212
1335033780000000000,7,9,122,36,37,211
1335033840000000000,7,4,122,36,38,207
1335033900000000000,7,11,0,36,39,93
1335033960000000000,7,6,0,37,37,87
1335034020000000000,7,7,0,36,38,88
1335034080000000000,7,7,0,37,38,89
1335034140000000000,8,6,0,36,38,88
1335034200000000000,7,6,0,36,38,87
1335034260000000000,7,6,1,36,38,88
1335034320000000000,7,10,1,37,38,93
1335034380000000000,7,10,0,36,38,91
1335034440000000000,7,9,0,36,38,90
1335034500000000000,7,9,0,37,38,91
1335034560000000000,7,9,0,36,39,91
1335034620000000000,7,10,0,36,38,91
1335034680000000000,7,9,1,37,38,92
1335034740000000000,7,6,0,36,38,87
1335034800000000000,7,10,0,36,38,91
1335034860000000000,7,5,0,36,38,86
1335034920000000000,7,5,0,36,38,86
1335034980000000000,7,9,7,36,38,97
1335035040000000000,7,5,0,37,39,88
1335035100000000000,7,5,0,36,38,86
1335035160000000000,7,7,0,37,38,89
1335035220000000000,7,9,0,36,38,90
1335035280000000000,7,5,0,37,38,87
1335035340000000000,7,10,0,36,38,91
1335035400000000000,7,5,0,36,38,86
1335035460000000000,7,9,143,36,38,233
1335035520000000000,7,9,130,36,38,220
1335035580000000000,7,5,127,35,38,212
1335035640000000000,7,10,127,36,38,218
1335035700000000000,7,9,126,38,38,218
1335035760000000000,7,7,125,36,38,213
1335035820000000000,7,7,124,37,38,213
1335035880000000000,7,10,124,37,38,216
1335035940000000000,7,9,124,37,38,215
1335036000000000000,7,6,121,36,38,208
1335036060000000000,7,6,0,36,38,87
1335036120000000000,7,6,0,37,39,89
1335036180000000000,7,9,0,38,38,92
1335036240000000000,7,11,0,36,38,92
1335036300000000000,7,6,0,36,39,88
1335036360000000000,7,4,0,38,38,87
1335036420000000000,7,10,0,37,38,92
1335036480000000000,7,10,0,36,38,91
1335036540000000000,7,5,0,37,38,87
1335036600000000000,6,10,1,37,39,93
1335036660000000000,7,4,0,36,38,85
1335036720000000000,7,5,0,36,38,86
1335036780000000000,7,9,0,37,38,91
1335036840000000000,7,6,0,37,38,88
1335036900000000000,7,5,1,36,38,87
1335036960000000000,7,5,0,37,38,87
1335037020000000000,7,5,0,36,38,86
1335037080000000000,7,6,0,38,38,89
1335037140000000000,7,9,1,36,38,91
1335037200000000000,7,6,0,36,38,87
1335037260000000000,7,9,0,36,37,89
1335037320000000000,7,7,1,38,38,91
1335037380000000000,7,6,0,38,38,89
1335037440000000000,7,6,0,37,38,88
1335037500000000000,7,6,0,38,38,89
1335037560000000000,7,10,0,36,38,91
1335037620000000000,7,5,0,38,38,88
1335037680000000000,7,6,0,36,38,87
1335037740000000000,7,9,1,36,38,91
1335037800000000000,7,10,0,37,38,92
1335037860000000000,7,7,0,37,38,89
1335037920000000000,7,9,0,37,37,90
1335037980000000000,7,10,149,36,38,240
1335038040000000000,7,5,135,36,38,221
1335038100000000000,7,9,128,38,38,220
1335038160000000000,7,10,127,37,37,218
1335038220000000000,7,9,125,38,37,216
1335038280000000000,7,6,124,36,38,211
1335038340000000000,7,5,124,37,38,211
1335038400000000000,7,7,123,38,38,213
1335038460000000000,7,7,123,37,37,211
1335038520000000000,7,10,122,37,37,213
1335038580000000000,7,7,0,37,38,89
1335038640000000000,7,10,10,37,38,102
1335038700000000000,7,5,0,36,38,86
1335038760000000000,7,9,0,38,38,92
1335038820000000000,7,5,0,37,38,87
1335038880000000000,7,9,0,37,39,92
1335038940000000000,7,5,0,37,37,86
1335039000000000000,7,11,0,37,38,93
1335039060000000000,7,7,0,37,38,89
1335039120000000000,7,6,0,37,38,88
1335039180000000000,7,9,0,38,38,92
1335039240000000000,7,7,0,38,38,90
1335039300000000000,7,7,0,38,38,90
1335039360000000000,7,11,0,38,37,93
1335039420000000000,7,9,0,38,38,92
1335039480000000000,7,9,0,38,38,92
1335039540000000000,7,7,1,37,38,90
1335039600000000000,7,10,0,36,38,91
1335039660000000000,7,10,0,37,38,92
1335039720000000000,7,7,143,38,38,233
1335039780000000000,7,9,130,36,38,220
1335039840000000000,7,9,127,38,38,219
1335039900000000000,7,6,127,38,38,216
1335039960000000000,7,7,126,37,37,214
1335040020000000000,7,7,125,37,37,213
1335040080000000000,7,6,126,38,38,215
1335040140000000000,7,9,127,37,38,218
1335040200000000000,7,10,129,37,38,221
1335040260000000000,7,6,127,38,38,216
1335040320000000000,7,10,7,35,38,97
1335040380000000000,7,7,7,38,37,96
1335040440000000000,7,6,7,38,38,96
1335040500000000000,7,7,7,38,38,97
1335040560000000000,7,9,7,37,38,98
1335040620000000000,7,6,7,37,38,95
1335040680000000000,7,10,7,37,39,100
1335040740000000000,7,7,7,37,38,96
1335040800000000000,7,6,7,37,38,95
1335040860000000000,7,6,7,36,38,94
1335040920000000000,7,9,149,37,38,240
1335040980000000000,7,5,136,37,38,223
1335041040000000000,7,9,135,37,38,226
1335041100000000000,7,9,135,38,38,227
1335041160000000000,7,6,134,36,38,221
1335041220000000000,7,9,133,37,38,224
1335041280000000000,7,9,132,37,38,223
1335041340000000000,7,5,132,36,38,218
1335041400000000000,7,10,131,37,38,223
1335041460000000000,7,9,131,36,38,221
1335041520000000000,7,6,131,37,38,219
1335041580000000000,7,7,131,38,38,221
1335041640000000000,7,5,130,37,38,217
1335041700000000000,7,5,132,38,38,220
1335041760000000000,7,12,128,38,38,223
1335041820000000000,7,9,126,36,38,216
1335041880000000000,7,5,124,36,38,210
1335041940000000000,7,10,123,37,38,215
1335042000000000000,7,5,0,37,38,87
1335042060000000000,7,9,0,36,38,90
1335042120000000000,7,10,0,38,38,93
1335042180000000000,7,5,1,36,38,87
1335042240000000000,7,11,1,37,38,94
1335042300000000000,7,9,0,38,39,93
1335042360000000000,7,10,1,38,39,95
1335042420000000000,7,7,0,37,39,90
1335042480000000000,7,5,0,37,38,87
1335042540000000000,7,9,0,38,38,92
1335042600000000000,7,11,1,37,38,94
1335042660000000000,7,6,0,37,38,88
1335042720000000000,7,11,1,37,38,94
1335042780000000000,7,10,0,38,38,93
1335042840000000000,7,6,0,38,38,89
1335042900000000000,7,10,0,37,38,92
1335042960000000000,7,7,0,36,38,88
1335043020000000000,7,6,0,36,38,87
1335043080000000000,7,9,0,37,38,91
1335043140000000000,7,9,0,37,38,91
1335043200000000000,338,0,147,36,38,559
1335043260000000000,7,0,134,37,229,407
1335043320000000000,7,0,128,36,286,457
1335043380000000000,7,0,128,36,260,431
1335043440000000000,7,0,127,38,323,495
1335043500000000000,7,0,127,37,274,445
1335043560000000000,7,0,125,36,265,433
1335043620000000000,7,0,124,37,243,411
1335043680000000000,7,0,123,38,249,417
1335043740000000000,7,0,122,37,233,399
1335043800000000000,7,0,0,36,228,271
1335043860000000000,7,0,1,37,219,264
1335043920000000000,7,0,0,36,224,267
1335043980000000000,7,0,0,38,224,269
1335044040000000000,7,0,0,37,234,278
1335044100000000000,7,0,1,37,223,268
1335044160000000000,7,0,0,36,233,276
1335044220000000000,7,0,0,38,239,284
1335044280000000000,7,0,0,37,251,295
1335044340000000000,7,0,1,38,249,295
1335044400000000000,7,0,0,38,275,320
1335044460000000000,8,0,1,37,272,318
1335044520000000000,8,0,1,37,262,308
1335044580000000000,7,0,0,38,243,288
1335044640000000000,7,0,0,36,263,306
1335044700000000000,7,0,1,36,208,252
1335044760000000000,7,0,1,38,231,277
1335044820000000000,8,0,0,37,306,351
1335044880000000000,7,0,0,37,278,322
1335044940000000000,7,0,0,37,260,304
1335045000000000000,7,0,1,37,272,317
1335045060000000000,7,0,0,38,256,301
1335045120000000000,7,0,0,38,280,325
1335045180000000000,7,0,0,37,268,312
1335045240000000000,7,0,0,37,265,309
1335045300000000000,7,0,10,38,256,311
1335045360000000000,7,0,7,38,250,302
1335045420000000000,8,0,1,37,224,270
1335045480000000000,7,0,0,37,246,290
1335045540000000000,7,0,150,38,240,435
1335045600000000000,7,0,142,37,232,418
1335045660000000000,7,0,129,36,212,384
1335045720000000000,8,0,127,37,228,400
1335045780000000000,7,0,127,37,227,398
1335045840000000000,7,0,126,36,218,387
1335045900000000000,7,0,125,37,220,389
1335045960000000000,7,0,124,37,222,390
1335046020000000000,7,0,124,37,267,435
1335046080000000000,7,0,123,38,264,432
1335046140000000000,7,0,0,37,267,311
1335046200000000000,7,0,0,37,265,309
1335046260000000000,7,0,0,37,253,297
1335046320000000000,7,0,0,37,232,276
1335046380000000000,7,0,0,38,185,230
1335046440000000000,7,0,0,38,182,227
1335046500000000000,7,0,0,38,235,280
1335046560000000000,7,0,0,37,233,277
1335046620000000000,7,0,0,37,188,232
1335046680000000000,7,0,0,38,230,275
1335046740000000000,7,0,0,37,233,277
1335046800000000000,7,0,0,37,237,281
1335046860000000000,7,0,1,36,233,277
1335046920000000000,7,0,1,37,256,301
1335046980000000000,7,0,1,37,265,310
1335047040000000000,7,0,1,38,238,284
1335047100000000000,8,0,1,37,250,296
1335047160000000000,8,0,1,37,284,330
1335047220000000000,8,0,1,38,334,381
1335047280000000000,8,0,1,38,373,420
1335047340000000000,8,0,1,38,206,253
1335047400000000000,8,0,1,37,267,313
1335047460000000000,7,0,0,36,236,279
1335047520000000000,7,0,0,37,274,318
1335047580000000000,7,0,0,38,262,307
1335047640000000000,7,0,0,36,276,319
1335047700000000000,7,0,0,36,280,323
1335047760000000000,7,0,0,37,264,308
1335047820000000000,7,0,0,36,269,312
1335047880000000000,7,0,0,36,209,252
1335047940000000000,7,0,0,37,266,310
1335048000000000000,7,0,0,37,49,93
1335048060000000000,7,0,82,37,49,175
1335048120000000000,7,0,10,36,49,102
1335048180000000000,7,0,148,37,49,241
1335048240000000000,7,0,136,37,49,229
1335048300000000000,7,0,135,38,49,229
1335048360000000000,7,0,136,36,49,228
1335048420000000000,7,0,135,36,49,227
1335048480000000000,7,0,134,38,50,229
1335048540000000000,7,0,133,36,49,225
1335048600000000000,7,0,133,37,49,226
1335048660000000000,7,0,132,38,49,226
1335048720000000000,7,0,132,38,49,226
1335048780000000000,7,0,131,38,48,224
1335048840000000000,7,0,130,37,49,223
1335048900000000000,7,0,131,38,49,225
1335048960000000000,7,0,130,37,49,223
1335049020000000000,7,0,130,38,50,225
1335049080000000000,7,0,130,37,49,223
1335049140000000000,7,0,130,38,48,223
1335049200000000000,7,0,130,37,49,223
1335049260000000000,7,0,129,38,49,223
1335049320000000000,7,0,129,37,49,222
1335049380000000000,7,0,129,38,49,223
1335049440000000000,7,0,129,38,49,223
1335049500000000000,7,0,7,37,49,100
1335049560000000000,7,0,7,37,49,100
1335049620000000000,7,0,7,38,49,101
1335049680000000000,7,0,7,38,49,101
1335049740000000000,7,0,7,36,49,99
1335049800000000000,7,0,7,37,49,100
1335049860000000000,7,0,7,37,38,89
1335049920000000000,7,5,10,37,39,98
1335049980000000000,7,11,0,37,38,93
1335050040000000000,7,12,153,37,38,247
1335050100000000000,7,5274,137,37,38,5493
1335050160000000000,7,4703,131,36,38,4915
1335050220000000000,7,4750,130,37,38,4962
1335050280000000000,7,4722,130,36,38,4933
1335050340000000000,7,4712,127,37,38,4921
1335050400000000000,7,4703,126,37,38,4911
1335050460000000000,7,4722,125,37,38,4929
1335050520000000000,7,4701,124,36,38,4906
1335050580000000000,7,4701,123,37,38,4906
1335050640000000000,7,4685,123,36,38,4889
1335050700000000000,7,4679,0,38,38,4762
1335050760000000000,7,4692,1,37,38,4775
1335050820000000000,7,4665,0,38,38,4748
1335050880000000000,7,4672,1,36,38,4754
1335050940000000000,7,4670,0,37,38,4752
1335051000000000000,7,4641,0,38,38,4724
1335051060000000000,7,4624,1,37,38,4707
1335051120000000000,7,4606,1,36,38,4688
1335051180000000000,7,4633,0,38,38,4716
1335051240000000000,7,4609,1,36,38,4691
1335051300000000000,7,4633,1,38,38,4717
1335051360000000000,7,4623,0,37,38,4705
1335051420000000000,7,243,1,37,38,326
1335051480000000000,7,244,1,38,38,328
1335051540000000000,7,236,1,36,37,317
1335051600000000000,7,4648,0,36,38,4729
1335051660000000000,7,4631,0,37,38,4713
1335051720000000000,7,4636,1,38,38,4720
1335051780000000000,7,249,1,37,38,332
1335051840000000000,7,242,1,37,38,325
1335051900000000000,7,252,1,36,38,334
1335051960000000000,7,253,0,38,37,335
1335052020000000000,7,246,0,36,38,327
1335052080000000000,7,247,0,38,38,330
1335052140000000000,7,252,0,37,38,334
1335052200000000000,7,254,0,37,39,337
1335052260000000000,7,255,0,36,38,336
1335052320000000000,7,259,0,37,38,341
1335052380000000000,7,260,1,38,38,344
1335052440000000000,7,253,0,36,38,334
1335052500000000000,7,0,0,36,39,82
1335052560000000000,7,0,148,36,38,229
1335052620000000000,7,0,135,36,38,216
1335052680000000000,7,0,127,37,37,208
1335052740000000000,7,0,127,38,38,210
1335052800000000000,7,0,126,36,37,206
1335052860000000000,7,0,125,37,38,207
1335052920000000000,7,0,124,37,38,206
1335052980000000000,7,0,124,37,38,206
1335053040000000000,7,0,122,38,38,205
1335053100000000000,7,0,123,36,38,204
1335053160000000000,7,0,1,37,38,83
1335053220000000000,7,0,0,35,37,79
1335053280000000000,7,0,0,36,38,81
1335053340000000000,7,0,0,37,38,82
1335053400000000000,7,0,0,37,38,82
1335053460000000000,7,0,1,37,38,83
1335053520000000000,7,0,10,37,38,92
1335053580000000000,7,0,7,36,38,88
1335053640000000000,7,0,0,37,38,82
1335053700000000000,7,0,0,36,38,81
1335053760000000000,7,0,1,38,38,84
1335053820000000000,7,0,0,37,39,83
1335053880000000000,7,0,81,36,38,162
1335053940000000000,7,0,0,36,38,81
1335054000000000000,7,0,0,37,38,82
1335054060000000000,7,0,0,37,38,82
1335054120000000000,7,0,1,35,38,81
1335054180000000000,7,0,0,37,38,82
1335054240000000000,7,0,0,36,38,81
1335054300000000000,7,0,0,37,37,81
1335054360000000000,7,0,0,37,38,82
1335054420000000000,7,0,0,37,38,82
1335054480000000000,7,0,0,37,38,82
1335054540000000000,7,0,7,36,38,88
1335054600000000000,7,0,7,37,37,88
1335054660000000000,7,0,148,37,38,230
1335054720000000000,7,0,141,37,38,223
1335054780000000000,7,0,138,37,38,220
1335054840000000000,7,0,135,36,38,216
1335054900000000000,7,0,135,37,38,217
1335054960000000000,7,0,135,36,38,216
1335055020000000000,7,0,134,37,38,216
1335055080000000000,7,0,133,36,38,214
1335055140000000000,7,0,133,36,38,214
1335055200000000000,7,0,131,37,38,213
1335055260000000000,7,0,132,36,38,213
1335055320000000000,7,0,132,38,38,215
1335055380000000000,7,0,132,36,39,214
1335055440000000000,7,0,212,37,38,294
1335055500000000000,7,0,132,36,39,214
1335055560000000000,7,0,134,35,38,214
1335055620000000000,7,0,132,36,38,213
1335055680000000000,7,0,131,35,38,211
1335055740000000000,7,0,130,37,38,212
1335055800000000000,7,0,210,36,38,291
1335055860000000000,7,0,131,38,38,214
1335055920000000000,7,0,131,36,38,212
1335055980000000000,7,0,131,36,38,212
1335056040000000000,7,0,131,37,38,213
1335056100000000000,7,0,130,36,39,212
1335056160000000000,7,0,130,38,37,212
1335056220000000000,7,0,129,36,38,210
1335056280000000000,7,0,130,36,38,211
1335056340000000000,7,0,129,37,38,211
1335056400000000000,7,0,129,36,38,210
1335056460000000000,7,0,128,36,38,209
1335056520000000000,7,0,128,36,38,209
1335056580000000000,7,0,129,37,38,211
1335056640000000000,7,0,7,35,38,87
1335056700000000000,7,0,7,36,38,88
1335056760000000000,7,0,7,35,38,87
1335056820000000000,7,0,7,35,38,87
1335056880000000000,7,0,7,37,38,89
1335056940000000000,7,0,7,36,38,88
1335057000000000000,7,0,7,38,38,90
1335057060000000000,7,0,7,36,38,88
1335057120000000000,7,0,7,36,38,88
1335057180000000000,7,0,158,36,39,240
1335057240000000000,7,0,141,35,38,221
1335057300000000000,7,0,136,37,38,218
1335057360000000000,7,0,136,37,38,218
1335057420000000000,7,0,135,36,38,216
1335057480000000000,7,0,135,37,38,217
1335057540000000000,7,0,135,36,38,216
1335057600000000000,7,0,133,36,38,214
1335057660000000000,7,0,132,36,37,212
1335057720000000000,7,0,132,36,38,213
1335057780000000000,7,0,131,38,38,214
1335057840000000000,7,0,127,37,38,209
1335057900000000000,7,0,126,36,39,208
1335057960000000000,7,0,125,36,38,206
1335058020000000000,7,0,125,38,38,208
1335058080000000000,7,0,124,37,38,206
1335058140000000000,7,0,122,36,38,203
1335058200000000000,7,0,0,37,37,81
1335058260000000000,7,0,0,37,38,82
1335058320000000000,7,0,1,38,39,85
1335058380000000000,7,0,0,37,38,82
1335058440000000000,7,0,0,36,38,81
1335058500000000000,7,0,1,36,38,82
1335058560000000000,7,0,0,36,38,81
1335058620000000000,7,0,0,37,38,82
1335058680000000000,7,0,0,37,38,82
1335058740000000000,7,0,0,37,38,82
1335058800000000000,7,0,0,37,38,82
1335058860000000000,7,0,0,36,38,81
1335058920000000000,7,0,0,37,38,82
1335058980000000000,7,0,0,37,38,82
1335059040000000000,7,0,0,38,38,83
1335059100000000000,7,0,0,35,38,80
1335059160000000000,7,0,0,37,38,82
1335059220000000000,7,0,0,36,38,81
1335059280000000000,7,0,0,36,38,81
1335059340000000000,7,0,0,37,38,82
1335059400000000000,7,0,0,35,38,80
1335059460000000000,7,0,0,35,39,81
1335059520000000000,7,0,0,36,38,81
1335059580000000000,7,0,1,38,38,84
1335059640000000000,7,0,0,36,38,81
1335059700000000000,7,0,0,36,38,81
1335059760000000000,7,0,0,36,38,81
1335059820000000000,7,0,0,38,38,83
1335059880000000000,7,0,0,37,38,82
1335059940000000000,7,0,0,37,38,82
1335060000000000000,7,0,146,36,38,227
1335060060000000000,7,0,134,36,38,215
1335060120000000000,7,0,127,37,38,209
1335060180000000000,7,0,127,36,38,208
1335060240000000000,7,0,126,38,38,209
1335060300000000000,7,0,125,1458,38,1628
1335060360000000000,7,0,124,1647,38,1816
1335060420000000000,7,0,123,1737,38,1905
1335060480000000000,7,0,122,1786,38,1953
1335060540000000000,7,0,122,1770,38,1937
1335060600000000000,7,0,0,1783,38,1828
1335060660000000000,7,0,0,1800,38,1845
1335060720000000000,7,0,0,1809,38,1854
1335060780000000000,7,0,0,1817,38,1862
1335060840000000000,7,0,1,1825,38,1871
1335060900000000000,7,0,0,1830,38,1875
1335060960000000000,7,0,0,1837,38,1882
1335061020000000000,7,0,0,1838,38,1883
1335061080000000000,7,0,0,1839,38,1884
1335061140000000000,7,0,0,1842,38,1887
1335061200000000000,7,0,0,1847,38,1892
1335061260000000000,7,0,0,1848,38,1893
1335061320000000000,7,0,0,1851,38,1896
1335061380000000000,7,0,7,1,38,53
1335061440000000000,7,0,0,1,38,46
1335061500000000000,7,0,0,1,38,46
1335061560000000000,7,0,0,1,38,46
1335061620000000000,7,0,0,1,38,46
1335061680000000000,7,0,0,1,38,46
1335061740000000000,7,0,0,1,37,45
1335061800000000000,7,0,0,1,38,46
1335061860000000000,7,0,0,1,38,46
1335061920000000000,7,0,0,2,37,46
1335061980000000000,7,0,0,1,38,46
1335062040000000000,7,0,1,1,38,47
1335062100000000000,7,0,0,1,38,46
1335062160000000000,7,0,152,0,38,197
1335062220000000000,7,0,137,1,38,183
1335062280000000000,7,0,134,1,38,180
1335062340000000000,7,0,133,1,37,178
1335062400000000000,7,0,132,0,38,177
1335062460000000000,7,0,132,0,38,177
1335062520000000000,7,0,132,1,38,178
1335062580000000000,7,0,131,1,38,177
1335062640000000000,7,0,131,1,38,177
1335062700000000000,7,0,130,1,38,176
1335062760000000000,7,0,129,1,38,175
1335062820000000000,7,0,129,1,37,174
1335062880000000000,7,0,128,41,37,213
1335062940000000000,7,0,128,38,38,211
1335063000000000000,7,0,129,38,38,212
1335063060000000000,7,0,130,36,38,211
1335063120000000000,7,0,128,36,38,209
1335063180000000000,7,0,128,37,38,210
1335063240000000000,7,0,7,37,38,89
1335063300000000000,7,0,7,38,38,90
1335063360000000000,7,0,7,37,38,89
1335063420000000000,7,0,7,36,38,88
1335063480000000000,7,0,7,37,38,89
1335063540000000000,7,0,7,37,38,89
1335063600000000000,7,0,7,38,38,90
1335063660000000000,7,0,7,37,38,89
1335063720000000000,7,0,7,37,39,90
1335063780000000000,7,0,155,37,38,237
1335063840000000000,7,0,139,37,38,221
1335063900000000000,7,0,132,37,38,214
1335063960000000000,7,0,132,38,38,215
1335064020000000000,7,0,129,38,38,212
1335064080000000000,7,0,127,37,38,209
1335064140000000000,7,0,127,37,37,208
1335064200000000000,7,0,126,37,39,209
1335064260000000000,7,0,125,36,38,206
1335064320000000000,7,0,123,38,38,206
1335064380000000000,7,0,122,37,38,204
1335064440000000000,7,0,122,36,38,203
1335064500000000000,7,0,1,38,38,84
1335064560000000000,7,0,0,38,38,83
1335064620000000000,7,0,0,36,38,81
1335064680000000000,7,0,0,38,38,83
1335064740000000000,7,0,0,37,38,82
1335064800000000000,7,0,0,38,38,83
1335064860000000000,7,0,0,37,38,82
1335064920000000000,7,0,0,37,38,82
1335064980000000000,7,0,0,36,38,81
1335065040000000000,7,0,0,38,37,82
1335065100000000000,7,0,0,36,37,80
1335065160000000000,7,0,0,36,37,80
1335065220000000000,7,0,0,37,38,82
1335065280000000000,7,0,0,38,38,83
1335065340000000000,7,0,0,37,38,82
1335065400000000000,7,0,0,37,39,83
1335065460000000000,7,0,0,37,37,81
1335065520000000000,7,0,0,37,39,83
1335065580000000000,7,0,0,36,38,81
1335065640000000000,7,0,0,36,38,81
1335065700000000000,7,0,0,37,38,82
1335065760000000000,7,0,0,37,38,82
1335065820000000000,7,0,0,37,38,82
1335065880000000000,7,0,0,37,38,82
1335065940000000000,7,0,0,37,39,83
1335066000000000000,7,0,0,36,38,81
1335066060000000000,7,0,0,37,38,82
1335066120000000000,7,0,0,37,37,81
1335066180000000000,7,0,0,37,38,82
1335066240000000000,7,0,0,36,38,81
1335066300000000000,7,0,0,38,38,83
1335066360000000000,7,0,0,38,38,83
1335066420000000000,7,0,147,37,39,230
1335066480000000000,7,0,132,38,37,214
1335066540000000000,7,0,127,36,38,208
1335066600000000000,7,0,127,38,38,210
1335066660000000000,7,0,126,36,38,207
1335066720000000000,7,0,128,37,37,209
1335066780000000000,334,0,130,38,38,540
1335066840000000000,334,0,128,37,223,722
1335066900000000000,335,0,127,37,228,727
1335066960000000000,338,0,126,37,212,713
1335067020000000000,336,0,124,37,282,779
1335067080000000000,334,0,124,38,188,684
1335067140000000000,335,0,0,37,233,605
1335067200000000000,334,0,0,37,214,585
1335067260000000000,334,0,0,38,355,727
1335067320000000000,334,0,0,37,208,579
1335067380000000000,333,0,0,37,209,579
1335067440000000000,336,0,0,36,229,601
1335067500000000000,334,0,10,37,264,645
1335067560000000000,334,0,0,37,351,722
1335067620000000000,333,0,0,37,308,678
1335067680000000000,334,0,0,37,218,589
1335067740000000000,335,0,0,38,221,594
1335067800000000000,335,0,0,37,218,590
1335067860000000000,335,0,0,37,214,586
1335067920000000000,337,0,0,37,358,732
1335067980000000000,338,0,0,37,290,665
1335068040000000000,336,0,0,36,239,611
1335068100000000000,338,0,0,38,210,586
1335068160000000000,337,0,0,38,222,597
1335068220000000000,338,0,0,38,222,598
1335068280000000000,339,0,0,37,232,608
1335068340000000000,338,0,0,37,197,572
1335068400000000000,338,0,0,37,230,605
1335068460000000000,335,0,0,38,396,769
1335068520000000000,337,0,0,37,256,630
1335068580000000000,337,0,0,37,194,568
1335068640000000000,338,0,148,37,214,737
1335068700000000000,336,0,134,36,217,723
1335068760000000000,337,0,129,36,217,719
1335068820000000000,338,0,128,37,194,697
1335068880000000000,338,0,127,37,224,726
1335068940000000000,337,0,125,36,208,706
1335069000000000000,337,0,125,38,223,723
1335069060000000000,337,0,125,37,225,724
1335069120000000000,337,0,122,38,225,722
1335069180000000000,339,0,122,37,224,722
1335069240000000000,339,0,0,37,244,620
1335069300000000000,339,0,0,38,264,641
1335069360000000000,339,0,0,37,292,668
1335069420000000000,339,0,0,37,228,604
1335069480000000000,339,0,0,37,243,619
1335069540000000000,330,0,0,37,275,642
1335069600000000000,331,0,0,37,254,622
1335069660000000000,330,0,0,36,213,579
1335069720000000000,331,0,0,37,221,589
1335069780000000000,331,0,0,36,222,589
1335069840000000000,331,0,0,36,233,600
1335069900000000000,330,0,0,36,326,692
1335069960000000000,329,0,0,36,241,606
1335070020000000000,329,0,0,36,251,616
1335070080000000000,330,0,0,37,238,605
1335070140000000000,330,0,0,37,220,587
1335070200000000000,331,0,0,36,252,619
1335070260000000000,332,0,0,36,227,595
1335070320000000000,332,0,0,36,330,698
1335070380000000000,333,0,0,38,246,617
1335070440000000000,333,0,0,38,337,708
1335070500000000000,333,0,0,36,220,589
1335070560000000000,333,0,0,37,304,674
1335070620000000000,333,0,0,36,223,592
1335070680000000000,334,0,0,36,280,650
1335070740000000000,333,0,0,38,401,772
1335070800000000000,333,0,0,36,250,619
1335070860000000000,333,0,0,37,359,729
1335070920000000000,334,0,0,38,272,644
1335070980000000000,334,0,0,37,256,627
1335071040000000000,334,0,0,37,252,623
1335071100000000000,334,0,10,36,232,612
1335071160000000000,334,0,10,35,253,632
1335071220000000000,335,0,150,37,236,758
1335071280000000000,330,0,134,35,243,742
1335071340000000000,330,0,128,37,243,738
1335071400000000000,331,0,127,37,265,760
1335071460000000000,330,0,126,36,368,860
1335071520000000000,331,0,125,36,297,789
1335071580000000000,334,0,124,37,228,723
1335071640000000000,335,0,124,37,308,804
1335071700000000000,336,0,123,37,289,785
1335071760000000000,336,0,122,36,249,743
1335071820000000000,336,0,0,36,240,612
1335071880000000000,336,0,0,37,235,608
1335071940000000000,336,0,10,36,233,615
1335072000000000000,336,0,7,37,225,605
1335072060000000000,336,0,7,36,258,637
1335072120000000000,337,0,7,36,235,615
1335072180000000000,336,0,7,36,270,649
1335072240000000000,337,0,7,37,385,766
1335072300000000000,337,0,7,37,298,679
1335072360000000000,337,0,7,36,245,625
1335072420000000000,337,0,7,36,235,615
1335072480000000000,338,0,7,38,246,629
1335072540000000000,337,0,154,37,228,756
1335072600000000000,334,0,138,37,249,758
1335072660000000000,334,0,135,36,396,901
1335072720000000000,335,0,135,37,254,761
1335072780000000000,335,0,134,37,265,771
1335072840000000000,335,0,134,36,293,798
1335072900000000000,338,0,132,37,231,738
1335072960000000000,338,0,132,38,254,762
1335073020000000000,339,0,133,38,233,743
1335073080000000000,339,0,131,37,323,830
1335073140000000000,338,0,131,37,250,756
1335073200000000000,333,0,130,36,379,878
1335073260000000000,334,0,129,36,242,741
1335073320000000000,333,0,129,37,382,881
1335073380000000000,334,0,128,37,218,717
1335073440000000000,334,0,129,37,272,772
1335073500000000000,334,0,128,36,226,724
1335073560000000000,334,0,128,36,248,746
1335073620000000000,335,0,7,36,222,600
1335073680000000000,335,0,10,37,217,599
1335073740000000000,336,0,0,37,231,604
1335073800000000000,336,0,0,36,220,592
1335073860000000000,335,0,0,36,211,582
1335073920000000000,334,0,0,36,250,620
1335073980000000000,333,0,0,36,246,615
1335074040000000000,334,0,0,37,253,624
1335074100000000000,333,0,0,37,205,575
1335074160000000000,334,0,0,37,225,596
1335074220000000000,335,0,0,36,219,590
1335074280000000000,336,0,0,36,233,605
1335074340000000000,335,0,0,37,228,600
1335074400000000000,334,0,0,38,212,584
1335074460000000000,335,0,148,36,226,745
1335074520000000000,335,0,134,38,225,732
1335074580000000000,335,0,127,36,220,718
1335074640000000000,334,0,127,36,229,726
1335074700000000000,334,0,125,38,228,725
1335074760000000000,335,0,124,36,249,744
1335074820000000000,334,0,124,38,222,718
1335074880000000000,335,0,122,37,382,876
1335074940000000000,336,0,122,36,216,710
1335075000000000000,337,0,0,37,216,590
1335075060000000000,336,0,0,37,208,581
1335075120000000000,337,0,0,38,216,591
1335075180000000000,335,0,0,37,227,599
1335075240000000000,336,0,0,36,218,590
1335075300000000000,335,0,0,38,273,646
1335075360000000000,338,0,0,37,243,618
1335075420000000000,337,0,0,35,220,592
1335075480000000000,338,0,0,37,221,596
1335075540000000000,335,0,0,36,228,599
1335075600000000000,335,0,0,36,259,630
1335075660000000000,334,0,0,36,217,587
1335075720000000000,335,0,0,38,236,609
1335075780000000000,339,0,0,38,217,594
1335075840000000000,339,0,0,38,216,593
1335075900000000000,338,0,0,37,235,610
1335075960000000000,339,0,0,38,224,601
1335076020000000000,338,0,0,38,237,613
1335076080000000000,337,0,0,36,240,613
1335076140000000000,336,0,0,37,244,617
1335076200000000000,337,0,0,37,225,599
1335076260000000000,337,0,0,37,266,640
1335076320000000000,338,0,0,38,381,757
1335076380000000000,337,0,0,37,293,667
1335076440000000000,337,0,0,37,222,596
1335076500000000000,337,0,0,37,216,590
1335076560000000000,337,0,0,36,239,612
1335076620000000000,337,0,0,38,251,626
1335076680000000000,338,0,0,38,267,643
1335076740000000000,337,0,0,37,265,639
1335076800000000000,336,0,0,38,301,675
1335076860000000000,7,6,1,36,37,87
1335076920000000000,7,9,1,37,37,91
1335076980000000000,7,0,0,38,39,84
1335077040000000000,7,0,142,37,38,224
1335077100000000000,7,0,129,38,39,213
1335077160000000000,7,0,127,36,38,208
1335077220000000000,7,0,127,38,38,210
1335077280000000000,7,0,130,39,38,214
1335077340000000000,7,0,128,38,39,212
1335077400000000000,7,0,125,36,39,207
1335077460000000000,7,0,125,37,39,208
1335077520000000000,7,0,125,38,38,208
1335077580000000000,7,0,1,38,39,85
1335077640000000000,7,0,0,37,38,82
1335077700000000000,7,0,0,38,38,83
1335077760000000000,7,0,0,37,38,82
1335077820000000000,7,0,0,37,39,83
1335077880000000000,7,0,0,37,38,82
1335077940000000000,7,0,0,37,38,82
